Rk,Player,Nation,Pos,Squad,Age,Born,90s,Tkl,TklW,Def 3rd,Mid 3rd,Att 3rd,Tkl,Att,Tkl%,Lost,Blocks,Sh,Pass,Int,Tkl+Int,Clr,Err,Matches
1,Max Aarons,eng ENG,"DF,MF",Valencia,24,2000,1.3,4,4,2,2,0,4,5,80,1,1,0,1,0,4,3,0,Matches
2,Rodrigo Abajas,es ESP,DF,Valencia,21,2003,0.7,3,2,2,1,0,3,3,100,0,1,0,1,1,4,0,0,Matches
3,Abel,es ESP,DF,Osasuna,23,2000,23,61,37,28,25,8,39,63,61.9,24,29,4,25,18,79,64,2,Matches
4,Nabil Aberdin,fr FRA,MF,Getafe,21,2002,2.9,6,4,3,3,0,1,1,100,0,3,0,3,0,6,5,0,Matches
5,Abdel Abqar,ma MAR,DF,Alavés,25,1999,27.4,36,23,24,11,1,20,34,58.8,14,28,18,10,39,75,146,1,Matches
6,Akor Adams,ng NGA,FW,Sevilla,24,2000,1.5,0,0,0,0,0,0,0,,0,1,0,1,0,0,1,0,Matches
7,Adrián,es ESP,GK,Betis,37,1987,19,0,0,0,0,0,0,3,0,3,0,0,0,0,0,14,3,Matches
8,Julen Agirrezabala,es ESP,GK,Athletic Club,23,2000,13.4,0,0,0,0,0,0,1,0,1,0,0,0,0,0,4,0,Matches
9,Lucien Agoume,fr FRA,MF,Sevilla,22,2002,23.5,70,32,23,37,10,27,39,69.2,12,30,11,19,41,111,42,0,Matches
10,Álvaro Aguado,es ESP,MF,Espanyol,28,1996,4.9,5,2,3,2,0,3,9,33.3,6,7,1,6,4,9,5,1,Matches
11,Lorenzo Aguado,es ESP,DF,Real Madrid,21,2002,0.1,0,0,0,0,0,0,0,,0,0,0,0,0,0,2,0,Matches
12,Nayef Aguerd,ma MAR,DF,Real Sociedad,28,1996,19.6,30,24,17,12,1,12,18,66.7,6,21,15,6,13,43,91,0,Matches
13,Joseph Aidoo,gh GHA,DF,Valladolid,28,1995,6.5,5,5,3,2,0,2,3,66.7,1,8,4,4,5,10,26,1,Matches
14,Joseph Aidoo,gh GHA,DF,Celta Vigo,28,1995,0,1,0,1,0,0,0,0,,0,0,0,0,0,1,0,0,Matches
15,Ilias Akhomach,ma MAR,"MF,FW",Villarreal,20,2004,6.5,12,7,4,4,4,6,12,50,6,8,0,8,3,15,13,0,Matches
16,David Alaba,at AUT,DF,Real Madrid,32,1992,3.5,1,0,1,0,0,0,0,,0,5,5,0,6,7,7,0,Matches
17,Ibrahim Alani,ng NGA,MF,Valladolid,18,2006,1.8,12,7,8,4,0,4,6,66.7,2,3,1,2,1,13,1,0,Matches
18,Raúl Albiol,es ESP,DF,Villarreal,38,1985,13.2,10,9,9,1,0,6,10,60,4,10,9,1,6,16,69,1,Matches
19,Omar Alderete,py PAR,DF,Getafe,27,1996,33,43,29,30,11,2,20,30,66.7,10,38,22,16,40,83,241,1,Matches
20,Carles Aleñá,es ESP,"MF,FW",Getafe,26,1998,5,6,3,2,3,1,4,13,30.8,9,9,1,8,0,6,7,0,Matches
21,Carles Aleñá,es ESP,"MF,FW",Alavés,26,1998,12.1,19,12,6,7,6,7,17,41.2,10,11,0,11,2,21,4,0,Matches
22,Alfon,es ESP,"FW,MF",Celta Vigo,25,1999,15.2,8,3,3,2,3,4,12,33.3,8,8,0,8,5,13,5,1,Matches
23,Tadeo Allende,ar ARG,FW,Celta Vigo,25,1999,0,0,0,0,0,0,0,0,,0,0,0,0,0,0,0,0,Matches
24,Domingos André Ribeiro Almeida,pt POR,"MF,FW",Valencia,24,2000,22,48,32,18,21,9,14,39,35.9,25,21,3,18,8,56,14,1,Matches
25,Iker Almena,es ESP,"FW,DF",Girona,20,2004,0.5,0,0,0,0,0,0,1,0,1,1,0,1,0,0,2,0,Matches
26,Marcos Alonso,es ESP,DF,Celta Vigo,33,1990,29.4,35,21,19,13,3,25,44,56.8,19,22,7,15,34,69,126,4,Matches
27,Adrià Altimira,es ESP,"DF,FW",Leganés,23,2001,18.1,41,24,26,12,3,24,40,60,16,15,6,9,15,56,54,2,Matches
28,Sergi Altimira,es ESP,MF,Betis,22,2001,21.9,61,37,17,38,6,36,60,60,24,28,1,27,24,85,43,3,Matches
29,Hugo Álvarez,es ESP,"MF,DF",Celta Vigo,21,2003,17.5,26,9,12,10,4,10,19,52.6,9,19,2,17,8,34,29,1,Matches
30,Julián Álvarez,ar ARG,FW,Atlético Madrid,24,2000,27.9,25,17,5,11,9,8,30,26.7,22,14,0,14,2,27,12,1,Matches
31,Yeray Álvarez,es ESP,DF,Athletic Club,29,1995,19.8,25,13,14,9,2,15,22,68.2,7,10,6,4,34,59,129,1,Matches
32,Selim Amallah,ma MAR,MF,Valladolid,27,1996,15.3,30,18,10,18,2,10,18,55.6,8,24,2,22,14,44,5,1,Matches
33,Amath,sn SEN,"FW,DF",Valladolid,28,1996,4.2,2,0,2,0,0,1,8,12.5,7,7,1,6,2,4,6,0,Matches
34,Marcos André,br BRA,FW,Valladolid,27,1996,13.2,10,6,3,5,2,5,13,38.5,8,18,2,16,3,13,10,0,Matches
35,Leandro Antonetti,pr PUR,FW,Sevilla,21,2003,0.3,0,0,0,0,0,0,0,,0,0,0,0,0,0,0,0,Matches
36,Antoniu,es ESP,"FW,MF",Espanyol,21,2002,11.4,21,10,9,8,4,9,21,42.9,12,14,2,12,8,29,11,1,Matches
37,Antony,br BRA,FW,Betis,24,2000,15.1,25,11,6,9,10,8,22,36.4,14,12,1,11,10,35,9,1,Matches
38,Anuar,ma MAR,"MF,FW",Valladolid,29,1995,19.1,38,27,21,12,5,15,28,53.6,13,24,8,16,18,56,26,1,Matches
39,Aritz Arambarri,es ESP,DF,Leganés,26,1998,2,1,1,1,0,0,1,1,100,0,2,2,0,3,4,8,0,Matches
40,Mauro Arambarri,uy URU,MF,Getafe,28,1995,29.6,48,29,10,33,5,22,48,45.8,26,35,6,29,15,63,46,0,Matches
41,Jon Aramburu,ve VEN,DF,Real Sociedad,22,2002,27.3,102,70,61,30,11,66,100,66,34,40,8,32,30,132,98,0,Matches
42,Ronald Araújo,uy URU,DF,Barcelona,25,1999,8.4,12,9,6,5,1,4,5,80,1,6,4,2,9,21,25,0,Matches
43,Adu Ares,es ESP,FW,Athletic Club,22,2001,0.2,0,0,0,0,0,0,1,0,1,0,0,0,0,0,0,0,Matches
44,Jesús Areso,es ESP,DF,Osasuna,25,1999,34.2,53,38,31,14,8,39,56,69.6,17,26,4,22,8,61,92,0,Matches
45,David Argüelles,es ESP,MF,Getafe,22,2002,0.1,0,0,0,0,0,0,0,,0,2,0,2,0,0,0,0,Matches
46,José Arnaiz,es ESP,"FW,MF",Osasuna,29,1995,1.5,7,5,3,3,1,4,7,57.1,3,2,0,2,5,12,1,0,Matches
47,Sergio Arribas,es ESP,DF,Betis,21,2003,1,7,4,4,3,0,6,7,85.7,1,2,2,0,3,10,4,0,Matches
48,Takuma Asano,jp JPN,"FW,MF",Mallorca,29,1994,11.7,13,9,5,7,1,6,11,54.5,5,7,0,7,6,19,9,0,Matches
49,Raúl Asencio,es ESP,DF,Real Madrid,21,2003,18.6,22,16,18,4,0,10,13,76.9,3,11,6,5,16,38,88,2,Matches
50,Iago Aspas,es ESP,"FW,MF",Celta Vigo,36,1987,19.4,13,8,4,5,4,8,20,40,12,18,1,17,8,21,5,0,Matches
51,Yaser Asprilla,co COL,"FW,MF",Girona,20,2003,15.6,22,12,6,8,8,8,23,34.8,15,14,0,14,7,29,7,1,Matches
52,Ezequiel Ávila,ar ARG,FW,Betis,30,1994,7.5,8,3,2,2,4,4,10,40,6,4,0,4,2,10,8,0,Matches
53,Adam Aznou,ma MAR,DF,Valladolid,18,2006,9.7,28,21,20,8,0,21,43,48.8,22,24,8,16,10,38,30,0,Matches
54,César Azpilicueta,es ESP,DF,Atlético Madrid,34,1989,9.7,25,14,12,9,4,17,23,73.9,6,10,2,8,5,30,32,0,Matches
55,Papa Ba,es ESP,MF,Girona,19,2004,0.5,1,1,1,0,0,0,0,,0,1,0,1,0,1,1,0,Matches
56,Loïc Bade,fr FRA,DF,Sevilla,24,2000,29.8,47,27,37,10,0,23,31,74.2,8,22,13,9,29,76,162,2,Matches
57,Alex Baena,es ESP,"MF,FW",Villarreal,23,2001,28.8,28,15,6,14,8,10,39,25.6,29,29,2,27,22,50,22,2,Matches
58,Juma Bah,sl SLE,DF,Valladolid,18,2006,9.6,10,7,7,3,0,3,5,60,2,15,8,7,12,22,60,0,Matches
59,Eric Bailly,ci CIV,DF,Villarreal,30,1994,6.9,12,4,6,6,0,3,4,75,1,12,6,6,6,18,29,0,Matches
60,Stefan Bajcetic,es ESP,"MF,DF",Las Palmas,19,2004,10.8,29,14,13,13,3,12,28,42.9,16,25,4,21,15,44,26,1,Matches
61,Cédric Bakambu,cd COD,FW,Betis,33,1991,7.9,6,4,0,5,1,3,7,42.9,4,13,2,11,0,6,5,0,Matches
62,Alejandro Balde,es ESP,DF,Barcelona,20,2003,25.4,18,10,10,5,3,11,17,64.7,6,24,5,19,5,23,27,0,Matches
63,Iván Balliu,al ALB,DF,Rayo Vallecano,32,1992,13.3,17,14,8,5,4,6,18,33.3,12,16,4,12,13,30,39,0,Matches
64,Jonathan Bamba,ci CIV,"FW,MF",Celta Vigo,28,1996,9,12,7,4,6,2,5,12,41.7,7,6,0,6,5,17,6,0,Matches
65,Adrian Baquerin,es ESP,FW,Valladolid,17,2007,0.5,1,1,0,1,0,0,0,,0,0,0,0,0,1,1,0,Matches
66,Valentín Barco,ar ARG,"DF,FW",Sevilla,20,2004,3.2,15,9,8,3,4,12,15,80,3,0,0,0,2,17,5,0,Matches
67,Borna Barišić,hr CRO,DF,Leganés,31,1992,0.1,0,0,0,0,0,0,0,,0,0,0,0,0,0,0,0,Matches
68,Kike Barja,es ESP,"FW,MF",Osasuna,27,1997,3.5,5,4,1,3,1,2,4,50,2,5,0,5,3,8,4,0,Matches
69,Enzo Barrenechea,ar ARG,MF,Valencia,23,2001,24.3,57,30,22,29,6,32,46,69.6,14,30,8,22,28,85,48,1,Matches
70,Ander Barrenetxea,es ESP,"MF,FW",Real Sociedad,22,2001,14,26,19,7,14,5,6,23,26.1,17,15,0,15,11,37,16,1,Matches
71,Pablo Barrios,es ESP,MF,Atlético Madrid,21,2003,25.9,46,26,23,20,3,23,47,48.9,24,18,5,13,34,80,33,9,Matches
72,Thierno Barry,fr FRA,FW,Villarreal,21,2002,25.8,11,8,2,5,4,4,10,40,6,15,2,13,0,11,19,0,Matches
73,Marc Bartra,es ESP,DF,Betis,33,1991,23.3,33,19,20,13,0,15,26,57.7,11,41,25,16,33,66,148,0,Matches
74,Aboubacar Bassinga,ci CIV,MF,Las Palmas,19,2005,0,0,0,0,0,0,0,0,,0,0,0,0,0,0,0,0,Matches
75,Augusto Batalla,ar ARG,GK,Rayo Vallecano,28,1996,32,4,2,4,0,0,4,6,66.7,2,0,0,0,0,4,15,4,Matches
76,Rafael Bauza,es ESP,MF,Espanyol,19,2005,2,5,3,3,1,1,4,7,57.1,3,3,1,2,0,5,5,0,Matches
77,Sheraldo Becker,sr SUR,"FW,MF",Real Sociedad,29,1995,11.1,3,2,0,3,0,0,2,0,2,4,0,4,1,4,10,0,Matches
78,Donny van de Beek,nl NED,MF,Girona,27,1997,15.8,29,18,17,7,5,13,26,50,13,19,3,16,10,39,12,0,Matches
79,Luken Beitia,es ESP,DF,Real Sociedad,20,2004,0.1,1,1,1,0,0,1,1,100,0,0,0,0,0,1,2,0,Matches
80,Ismael Bekhoucha,ma MAR,"MF,DF",Getafe,19,2004,0.8,1,1,1,0,0,1,2,50,1,2,1,1,2,3,2,0,Matches
81,Héctor Bellerín,es ESP,DF,Betis,29,1995,6.4,13,7,7,4,2,10,17,58.8,7,5,3,2,6,19,21,0,Matches
82,Jude Bellingham,eng ENG,MF,Real Madrid,21,2003,27.6,61,33,20,27,14,28,42,66.7,14,37,2,35,28,89,23,1,Matches
83,Fran Beltrán,es ESP,MF,Celta Vigo,25,1999,26.9,50,35,24,21,5,24,56,42.9,32,26,6,20,26,76,34,4,Matches
84,Carlos Benavídez,uy URU,MF,Alavés,26,1998,5.4,19,14,10,6,3,6,11,54.5,5,5,2,3,8,27,14,1,Matches
85,Iker Benito,es ESP,"FW,MF",Osasuna,21,2002,0.4,0,0,0,0,0,0,1,0,1,0,0,0,1,1,2,0,Matches
86,Yuri Berchiche,es ESP,DF,Athletic Club,34,1990,22.7,33,21,19,11,3,19,33,57.6,14,25,5,20,27,60,72,3,Matches
87,Álex Berenguer,es ESP,"FW,MF",Athletic Club,29,1995,26,32,16,6,16,10,14,31,45.2,17,23,2,21,10,42,18,0,Matches
88,Marc Bernal,es ESP,MF,Barcelona,17,2007,2.7,8,6,2,5,1,7,8,87.5,1,5,1,4,1,9,4,0,Matches
89,Juan Bernat,es ESP,"DF,MF",Villarreal,31,1993,2.4,9,7,7,1,1,4,5,80,1,3,1,2,1,10,4,0,Matches
90,Juan Bernat,es ESP,"MF,DF",Getafe,31,1993,7.8,19,13,9,5,5,7,12,58.3,5,9,3,6,2,21,12,0,Matches
91,Juan Berrocal,es ESP,DF,Getafe,25,1999,11.8,14,7,10,4,0,10,14,71.4,4,6,3,3,15,29,59,0,Matches
92,Antonio Blanco,es ESP,MF,Alavés,24,2000,30.3,67,40,23,37,7,32,83,38.6,51,30,7,23,42,109,48,1,Matches
93,Daley Blind,nl NED,DF,Girona,34,1990,30.9,49,27,26,19,4,31,48,64.6,17,32,9,23,32,81,94,2,Matches
94,Adama Boiro,es ESP,"DF,FW",Athletic Club,22,2002,12.2,20,11,11,7,2,10,15,66.7,5,10,3,7,12,32,27,1,Matches
95,Enzo Boyomo,cm CMR,DF,Osasuna,22,2001,33.2,68,43,46,18,4,30,39,76.9,9,34,19,15,44,112,137,3,Matches
96,Enzo Boyomo,cm CMR,DF,Valladolid,22,2001,3,6,2,4,2,0,3,3,100,0,4,3,1,1,7,7,0,Matches
97,Darko Brašanac,rs SRB,MF,Leganés,32,1992,18,26,11,5,15,6,9,17,52.9,8,24,11,13,16,42,34,0,Matches
98,Tajon Buchanan,ca CAN,MF,Villarreal,25,1999,4.6,10,5,6,4,0,6,9,66.7,3,6,0,6,1,11,1,0,Matches
99,Ante Budimir,hr CRO,FW,Osasuna,33,1991,32.8,20,9,3,11,6,3,13,23.1,10,19,4,15,2,22,26,0,Matches
100,Manu Bueno,es ESP,"MF,FW",Sevilla,20,2004,1.6,4,3,0,1,3,1,2,50,1,0,0,0,0,4,2,0,Matches
101,Endika Buján,es ESP,FW,Athletic Club,21,2003,0.1,0,0,0,0,0,0,1,0,1,0,0,0,0,0,0,0,Matches
102,Pau Cabanes,es ESP,"MF,FW",Villarreal,19,2005,1.8,4,4,0,3,1,3,4,75,1,5,0,5,3,7,2,1,Matches
103,Pau Cabanes,es ESP,"MF,FW",Alavés,19,2005,2.1,8,2,4,3,1,6,13,46.2,7,2,0,2,0,8,1,0,Matches
104,Leandro Cabrera,uy URU,DF,Espanyol,33,1991,31.9,40,23,29,8,3,19,33,57.6,14,35,25,10,30,70,199,2,Matches
105,Fernando Calero,es ESP,"DF,MF",Espanyol,28,1995,7.9,18,10,13,4,1,8,12,66.7,4,16,9,7,16,34,50,1,Matches
106,Eduardo Camavinga,fr FRA,"MF,DF",Real Madrid,21,2002,12.2,42,26,23,16,3,19,33,57.6,14,24,8,16,18,60,23,0,Matches
107,Sergio Camello,es ESP,FW,Rayo Vallecano,23,2001,12.6,9,3,2,5,2,4,6,66.7,2,8,1,7,4,13,16,0,Matches
108,José Campaña,es ESP,MF,Las Palmas,31,1993,13.2,21,16,8,11,2,11,20,55,9,9,1,8,19,40,19,2,Matches
109,Peio Canales,es ESP,"MF,FW",Athletic Club,19,2005,2.9,3,2,0,1,2,1,1,100,0,3,0,3,2,5,2,0,Matches
110,Antonio Candela,it ITA,DF,Valladolid,24,2000,10.1,9,6,6,2,1,4,11,36.4,7,11,6,5,6,15,33,0,Matches
111,Sergi Canós,es ESP,"MF,FW",Valencia,27,1997,4.1,11,7,3,4,4,4,10,40,6,6,1,5,5,16,5,0,Matches
112,Dani Cárdenas,es ESP,GK,Rayo Vallecano,27,1997,6,0,0,0,0,0,0,0,,0,0,0,0,0,0,3,0,Matches
113,Irvin Cardona,fr FRA,"FW,MF",Espanyol,26,1997,6.7,8,5,2,4,2,6,16,37.5,10,5,1,4,4,12,10,0,Matches
114,Marc Cardona,es ESP,"FW,DF",Las Palmas,29,1995,1.5,4,2,1,3,0,0,1,0,1,0,0,0,0,4,0,0,Matches
115,Sergi Cardona,es ESP,DF,Villarreal,25,1999,32.7,71,48,44,20,7,49,79,62,30,52,7,45,40,111,122,1,Matches
116,Johnny Cardoso,us USA,MF,Betis,22,2001,23.8,55,31,12,35,8,20,52,38.5,32,27,12,15,48,103,64,1,Matches
117,José Carlos González,es ESP,DF,Las Palmas,18,2006,0.1,0,0,0,0,0,0,0,,0,0,0,0,0,0,0,0,Matches
118,Carmona,es ESP,DF,Sevilla,22,2002,32.7,83,59,53,21,9,41,77,53.2,36,37,11,26,68,151,92,3,Matches
119,Sergio Carreira,es ESP,"MF,DF",Celta Vigo,23,2000,18.4,28,16,16,6,6,14,26,53.8,12,20,2,18,17,45,37,0,Matches
120,Dani Carvajal,es ESP,DF,Real Madrid,32,1992,6.8,12,8,7,3,2,9,12,75,3,8,3,5,10,22,19,1,Matches
121,William Carvalho,pt POR,MF,Betis,32,1992,5.4,9,6,3,6,0,4,6,66.7,2,6,2,4,3,12,6,0,Matches
122,Marc Casado,es ESP,MF,Barcelona,20,2003,17.9,44,25,7,30,7,20,41,48.8,21,20,5,15,22,66,22,1,Matches
123,Catena,es ESP,DF,Osasuna,29,1994,34.2,46,28,34,10,2,27,44,61.4,17,40,25,15,35,81,221,2,Matches
124,Maximiliano Caufriez,be BEL,DF,Valencia,27,1997,1,1,1,1,0,0,1,1,100,0,2,1,1,1,2,4,0,Matches
125,Dani Ceballos,es ESP,MF,Real Madrid,27,1996,13.5,41,21,17,18,6,20,40,50,20,16,4,12,14,55,10,2,Matches
126,Franco Cervi,ar ARG,"FW,MF",Celta Vigo,30,1994,3,8,3,2,6,0,3,8,37.5,5,4,0,4,8,16,7,0,Matches
127,Raúl Chasco,es ESP,DF,Valladolid,20,2003,1.4,4,1,3,1,0,2,4,50,2,1,0,1,2,6,2,0,Matches
128,Pep Chavarría,es ESP,"DF,FW",Rayo Vallecano,26,1998,28.7,46,36,30,14,2,28,45,62.2,17,35,9,26,30,76,108,1,Matches
129,Walid Cheddira,ma MAR,FW,Espanyol,26,1998,7.1,5,0,1,1,3,0,1,0,1,4,0,4,1,6,6,0,Matches
130,Chema,es ESP,MF,Real Madrid,19,2005,0.1,0,0,0,0,0,0,0,,0,0,0,0,0,0,1,0,Matches
131,Julián Chicco,ar ARG,"MF,DF",Leganés,26,1998,3.4,11,7,3,6,2,5,8,62.5,3,2,0,2,4,15,10,0,Matches
132,Chiquinho,pt POR,"MF,FW",Mallorca,24,2000,1.6,1,0,0,1,0,0,7,0,7,3,0,3,2,3,0,0,Matches
133,Andreas Christensen,dk DEN,DF,Barcelona,28,1996,2.8,6,4,4,1,1,4,4,100,0,2,0,2,4,10,9,0,Matches
134,Jasper Cillessen,nl NED,GK,Las Palmas,35,1989,25.9,1,0,1,0,0,1,4,25,3,0,0,0,0,1,11,2,Matches
135,Pathé Ciss,sn SEN,"MF,DF",Rayo Vallecano,30,1994,23.8,49,24,26,22,1,20,41,48.8,21,31,10,21,40,89,61,3,Matches
136,Seydouba Cissé,gn GUI,MF,Leganés,23,2001,27.1,59,37,18,27,14,23,50,46,27,25,1,24,12,71,45,1,Matches
137,Silvi Clúa,es ESP,MF,Girona,19,2005,1.8,8,7,4,3,1,4,6,66.7,2,1,0,1,2,10,6,0,Matches
138,Eray Cömert,ch SUI,"DF,MF",Valladolid,26,1998,19.8,24,14,15,9,0,12,21,57.1,9,28,15,13,24,48,75,2,Matches
139,Santi Comesaña,es ESP,MF,Villarreal,27,1996,28.4,85,49,44,32,9,42,76,55.3,34,56,22,34,19,104,56,1,Matches
140,Diego Conde,es ESP,GK,Villarreal,25,1998,21.8,2,2,2,0,0,2,4,50,2,0,0,0,1,3,9,2,Matches
141,Tomás Conechny,ar ARG,"FW,MF",Alavés,26,1998,9.4,15,12,6,7,2,9,27,33.3,18,14,2,12,6,21,10,0,Matches
142,Copete,es ESP,DF,Mallorca,24,1999,17,29,17,18,10,1,11,12,91.7,1,24,16,8,17,46,123,2,Matches
143,Iker Córdoba,es ESP,DF,Valencia,18,2005,0.2,0,0,0,0,0,0,0,,0,0,0,0,0,0,1,0,Matches
144,Ángel Correa,ar ARG,"FW,MF",Atlético Madrid,29,1995,8.9,9,3,4,1,4,5,15,33.3,10,10,0,10,4,13,8,0,Matches
145,Thierry Correia,pt POR,DF,Valencia,25,1999,8.5,27,18,19,5,3,13,23,56.5,10,10,1,9,4,31,18,0,Matches
146,Coba da Costa,es ESP,"MF,FW",Getafe,22,2002,11.2,29,13,9,16,4,13,26,50,13,24,0,24,8,37,10,0,Matches
147,Logan Costa,cv CPV,DF,Villarreal,23,2001,28.7,38,21,25,12,1,24,29,82.8,5,25,14,11,21,59,115,2,Matches
148,Samu Costa,pt POR,MF,Mallorca,23,2000,29.4,90,44,45,42,3,35,79,44.3,44,48,15,33,32,122,85,1,Matches
149,Thibaut Courtois,be BEL,GK,Real Madrid,32,1992,30,0,0,0,0,0,0,0,,0,0,0,0,1,1,15,1,Matches
150,Juan Cruz Armada,es ESP,DF,Osasuna,32,1992,16.6,26,14,11,13,2,15,24,62.5,9,15,4,11,9,35,68,0,Matches
151,Juan Cruz,es ESP,"FW,MF",Leganés,24,2000,25.1,32,19,14,16,2,17,35,48.6,18,18,2,16,13,45,31,0,Matches
152,Pau Cubarsí,es ESP,DF,Barcelona,17,2007,29.1,34,23,21,10,3,19,30,63.3,11,12,9,3,16,50,86,1,Matches
153,Cucho,co COL,FW,Betis,25,1999,12.7,15,10,2,5,8,6,11,54.5,5,13,1,12,7,22,4,0,Matches
154,Arnaut Danjuma,nl NED,FW,Villarreal,27,1997,2.2,2,1,0,1,1,0,1,0,1,1,0,1,0,2,0,0,Matches
155,Arnaut Danjuma,nl NED,"FW,MF",Girona,27,1997,14.8,8,6,3,3,2,2,7,28.6,5,5,1,4,2,10,4,0,Matches
156,Sergi Darder,es ESP,"MF,FW",Mallorca,30,1993,30.5,40,26,15,16,9,17,46,37,29,19,1,18,16,56,23,1,Matches
157,Rodrigo De Paul,ar ARG,MF,Atlético Madrid,30,1994,23.4,33,26,12,16,5,14,33,42.4,19,25,2,23,6,39,15,3,Matches
158,Mouctar Diakhaby,gn GUI,DF,Valencia,27,1996,7.3,8,3,8,0,0,4,6,66.7,2,8,6,2,11,19,56,0,Matches
159,Assane Diao,sn SEN,FW,Betis,18,2005,3.1,5,3,1,3,1,4,9,44.4,5,3,0,3,0,5,3,0,Matches
160,Moussa Diarra,ml MLI,DF,Alavés,23,2000,20.7,40,24,19,18,3,17,29,58.6,12,15,5,10,21,61,46,1,Matches
161,Brahim Díaz,ma MAR,"FW,MF",Real Madrid,24,1999,15.4,25,19,9,13,3,7,19,36.8,12,16,1,15,4,29,2,1,Matches
162,Daniel Díaz,es ESP,MF,Real Sociedad,18,2006,0.1,1,1,1,0,0,0,0,,0,1,0,1,0,1,0,0,Matches
163,Pedro Díaz,es ESP,MF,Rayo Vallecano,26,1998,13.5,23,15,7,14,2,14,41,34.1,27,16,0,16,7,30,7,1,Matches
164,Diego,es ESP,FW,Leganés,24,2000,13.3,1,1,0,0,1,1,7,14.3,6,4,1,3,2,3,11,0,Matches
165,Stole Dimitrievski,mk MKD,GK,Valencia,30,1993,4,0,0,0,0,0,0,0,,0,0,0,0,0,0,3,1,Matches
166,Yan Diomandé,ci CIV,"MF,FW",Leganés,17,2006,6.1,14,9,1,8,5,5,15,33.3,10,8,0,8,8,22,6,0,Matches
167,Álvaro djaló,es ESP,FW,Athletic Club,24,1999,7.3,8,5,3,2,3,1,3,33.3,2,4,0,4,1,9,4,0,Matches
168,Djené,tg TOG,"DF,MF",Getafe,32,1991,28.3,25,13,12,11,2,12,32,37.5,20,18,8,10,21,46,107,3,Matches
169,Marko Dmitrović,rs SRB,GK,Leganés,32,1992,32,1,1,1,0,0,1,2,50,1,0,0,0,0,1,27,3,Matches
170,Marc Domenech,es ESP,"FW,MF",Mallorca,18,2006,3.4,4,4,2,1,1,2,5,40,3,2,0,2,0,4,2,0,Matches
171,Carlos Dominguez,es ESP,DF,Celta Vigo,23,2001,13.1,23,11,14,9,0,15,21,71.4,6,16,11,5,13,36,80,1,Matches
172,Israel Domínguez,es ESP,FW,Sevilla,21,2003,0.2,0,0,0,0,0,0,0,,0,0,0,0,0,0,0,0,Matches
173,Sergi Dominguez,es ESP,DF,Barcelona,19,2005,1.9,1,1,1,0,0,0,0,,0,0,0,0,3,4,7,0,Matches
174,Anastasios Douvikas,gr GRE,FW,Celta Vigo,24,1999,7.8,9,4,2,6,1,3,6,50,3,5,2,3,3,12,6,0,Matches
175,Domingos Duarte,pt POR,DF,Getafe,29,1995,20.7,28,15,22,4,2,17,21,81,4,28,16,12,18,46,152,1,Matches
176,Duk,cv CPV,"MF,FW",Leganés,24,2000,2,8,4,3,3,2,3,5,60,2,4,0,4,1,9,2,0,Matches
177,Pablo Durán,es ESP,"FW,MF",Celta Vigo,23,2001,15.5,17,9,4,7,6,5,16,31.3,11,12,3,9,8,25,18,0,Matches
178,Hugo Duro,es ESP,FW,Valencia,24,1999,24.1,13,8,4,7,2,5,13,38.5,8,11,2,9,10,23,11,0,Matches
179,Chidera Ejuke,ng NGA,FW,Sevilla,26,1998,10.7,19,13,8,9,2,9,20,45,11,12,0,12,5,24,8,0,Matches
180,Aritz Elustondo,es ESP,DF,Real Sociedad,30,1994,16.2,20,11,15,3,2,11,19,57.9,8,17,12,5,11,31,96,0,Matches
181,Adri Embarba,es ESP,"FW,MF",Rayo Vallecano,32,1992,17.9,41,20,17,17,7,18,47,38.3,29,18,1,17,13,54,14,2,Matches
182,Endrick,br BRA,FW,Real Madrid,18,2006,4,1,1,1,0,0,1,3,33.3,2,0,0,0,4,5,1,0,Matches
183,Alfonso Espino,uy URU,DF,Rayo Vallecano,32,1992,9.3,41,24,31,8,2,26,47,55.3,21,19,6,13,12,53,32,1,Matches
184,Dario Essugo,pt POR,MF,Las Palmas,19,2005,21.5,59,45,28,26,5,28,46,60.9,18,28,11,17,42,101,47,7,Matches
185,Etienne Eto'o,cm CMR,FW,Rayo Vallecano,21,2002,0.4,0,0,0,0,0,0,1,0,1,0,0,0,0,0,1,0,Matches
186,Karl Etta,cm CMR,"MF,FW",Villarreal,20,2003,0.4,0,0,0,0,0,0,1,0,1,1,0,1,0,0,0,0,Matches
187,Edu Expósito,es ESP,MF,Espanyol,27,1996,11.6,23,13,9,13,1,9,23,39.1,14,3,0,3,15,38,21,2,Matches
188,Abde Ezzalzouli,ma MAR,"FW,MF",Betis,22,2001,22,37,25,17,16,4,15,27,55.6,12,22,3,19,7,44,19,0,Matches
189,Ansu Fati,es ESP,FW,Barcelona,21,2002,2.6,4,1,0,2,2,1,2,50,1,1,0,1,1,5,0,1,Matches
190,Nabil Fekir,fr FRA,MF,Betis,31,1993,2,3,2,1,1,1,1,2,50,1,2,0,2,0,3,0,0,Matches
191,Kiko Femenía,es ESP,DF,Villarreal,33,1991,24.7,50,34,34,14,2,33,57,57.9,24,21,10,11,40,90,62,3,Matches
192,Aitor Fernández,es ESP,GK,Osasuna,33,1991,1,0,0,0,0,0,0,0,,0,0,0,0,0,0,2,0,Matches
193,Álvaro Fernández,es ESP,GK,Sevilla,26,1998,8.3,0,0,0,0,0,0,1,0,1,0,0,0,0,0,7,0,Matches
194,Pelayo Fernandez,es ESP,DF,Rayo Vallecano,21,2003,1.1,0,0,0,0,0,0,0,,0,0,0,0,2,2,9,0,Matches
195,Roberto Férnandez,es ESP,FW,Espanyol,22,2002,16.6,4,4,2,1,1,0,5,0,5,9,1,8,3,7,26,0,Matches
196,Valery Fernández,es ESP,"MF,FW",Mallorca,24,1999,3.4,8,7,3,2,3,5,7,71.4,2,3,1,2,0,8,1,0,Matches
197,André Ferreira,pt POR,GK,Valladolid,28,1996,6,0,0,0,0,0,0,0,,0,0,0,0,0,0,4,2,Matches
198,Mateo Flores,es ESP,MF,Betis,20,2004,1.7,3,1,3,0,0,1,1,100,0,1,0,1,2,5,3,0,Matches
199,Pablo Fornals,es ESP,"MF,FW",Betis,28,1996,20.3,21,13,12,6,3,10,30,33.3,20,24,4,20,23,44,15,1,Matches
200,Héctor Fort,es ESP,DF,Barcelona,17,2006,6.5,13,8,6,4,3,10,16,62.5,6,12,0,12,6,19,16,0,Matches
201,Dimitri Foulquier,fr FRA,DF,Valencia,31,1993,25.5,48,31,29,13,6,24,36,66.7,12,21,5,16,16,64,86,1,Matches
202,Juan Foyth,ar ARG,DF,Villarreal,26,1998,16.9,25,15,15,6,4,11,16,68.8,5,26,17,9,19,44,119,3,Matches
203,Fran,es ESP,GK,Real Madrid,19,2005,1,0,0,0,0,0,0,0,,0,0,0,0,0,0,2,0,Matches
204,Alejandro Francés,es ESP,DF,Girona,21,2002,13,36,24,22,13,1,28,40,70,12,17,8,9,17,53,52,0,Matches
205,Enric Franquesa,es ESP,"DF,FW",Leganés,27,1997,6.8,17,9,9,6,2,9,13,69.2,4,7,1,6,5,22,12,0,Matches
206,Jorge de Frutos,es ESP,"FW,MF",Rayo Vallecano,27,1997,27.7,37,21,16,13,8,14,46,30.4,32,22,0,22,19,56,24,1,Matches
207,Darío Fuentes,es ESP,DF,Sevilla,21,2003,0.1,0,0,0,0,0,0,0,,0,0,0,0,0,0,0,0,Matches
208,Manuel Fuster,es ESP,"FW,MF",Las Palmas,26,1997,11.1,19,11,5,8,6,15,28,53.6,13,13,3,10,4,23,17,0,Matches
209,Javi Galán,es ESP,DF,Atlético Madrid,29,1994,19.8,51,31,31,15,5,25,49,51,24,13,3,10,12,63,47,0,Matches
210,Iñigo Ruiz de Galarreta,es ESP,MF,Athletic Club,30,1993,16.4,36,22,11,17,8,20,31,64.5,11,11,4,7,16,52,14,2,Matches
211,Conor Gallagher,eng ENG,MF,Atlético Madrid,24,2000,18.1,45,32,16,19,10,22,49,44.9,27,23,5,18,20,65,23,0,Matches
212,Facundo Garcés,ar ARG,DF,Alavés,24,1999,7.5,6,2,4,2,0,3,5,60,2,8,6,2,5,11,51,0,Matches
213,Álvaro García,es ESP,"FW,MF",Rayo Vallecano,31,1992,28.4,33,24,19,8,6,12,31,38.7,19,31,0,31,32,65,42,1,Matches
214,Eric García,es ESP,"DF,MF",Barcelona,23,2001,17.4,38,21,11,24,3,20,29,69,9,24,8,16,14,52,41,0,Matches
215,Fran Garcia,es ESP,DF,Real Madrid,24,1999,24.1,51,36,29,16,6,28,51,54.9,23,27,5,22,28,79,67,1,Matches
216,Gonzalo García,es ESP,"FW,DF",Real Madrid,20,2004,0.6,0,0,0,0,0,0,0,,0,1,0,1,0,0,0,0,Matches
217,Joan García,es ESP,GK,Espanyol,23,2001,38,0,0,0,0,0,0,1,0,1,1,0,1,0,0,18,4,Matches
218,Pablo Garcia,es ESP,FW,Betis,17,2006,0.4,0,0,0,0,0,0,0,,0,1,0,1,0,0,0,0,Matches
219,Rubén García,es ESP,"FW,MF",Osasuna,31,1993,26.8,52,31,20,21,11,26,60,43.3,34,37,3,34,15,67,34,1,Matches
220,Unai García,es ESP,DF,Osasuna,32,1992,0.7,0,0,0,0,0,0,0,,0,1,0,1,0,0,1,0,Matches
221,Yarek Gasiorowski,es ESP,DF,Valencia,19,2005,10.5,19,16,16,3,0,9,13,69.2,4,17,6,11,26,45,60,0,Matches
222,Gavi,es ESP,"MF,FW",Barcelona,19,2004,12.1,30,21,10,15,5,15,26,57.7,11,14,1,13,10,40,7,0,Matches
223,Paulo Gazzaniga,ar ARG,GK,Girona,32,1992,35.5,1,1,1,0,0,1,1,100,0,1,0,1,0,1,17,3,Matches
224,Bryan Gil,es ESP,"FW,MF",Girona,23,2001,19.1,34,20,10,15,9,14,30,46.7,16,24,0,24,10,44,9,4,Matches
225,Dani Gómez,es ESP,FW,Valencia,26,1998,5.9,3,2,0,0,3,0,0,,0,1,0,1,2,5,4,0,Matches
226,Moi Gómez,es ESP,"MF,FW",Osasuna,30,1994,8.8,13,9,4,7,2,4,8,50,4,5,2,3,6,19,7,1,Matches
227,Sergi Gómez,es ESP,DF,Espanyol,32,1992,7.4,8,5,7,1,0,2,3,66.7,1,12,8,4,7,15,38,0,Matches
228,Sergio Gómez,es ESP,"MF,DF",Real Sociedad,23,2000,30.4,71,39,30,29,12,30,56,53.6,26,44,3,41,19,90,30,2,Matches
229,Unai Gómez,es ESP,"MF,FW",Athletic Club,21,2003,14.3,12,8,3,7,2,4,7,57.1,3,13,1,12,2,14,15,1,Matches
230,Fabio González,es ESP,MF,Las Palmas,27,1997,0.6,0,0,0,0,0,0,1,0,1,0,0,0,0,0,0,0,Matches
231,Peter González,do DOM,"MF,FW",Getafe,22,2002,5.3,11,6,2,5,4,6,9,66.7,3,8,0,8,2,13,5,0,Matches
232,Urko González,es ESP,MF,Espanyol,23,2001,15.3,46,28,24,21,1,28,44,63.6,16,27,12,15,8,54,39,1,Matches
233,Urko González,es ESP,MF,Real Sociedad,23,2001,0.5,0,0,0,0,0,0,0,,0,1,1,0,0,0,0,0,Matches
234,Andoni Gorosabel,es ESP,DF,Athletic Club,27,1996,16.5,47,28,31,9,7,30,45,66.7,15,18,2,16,18,65,62,0,Matches
235,José Gragera,es ESP,MF,Espanyol,23,2000,6.3,25,16,11,14,0,9,17,52.9,8,9,1,8,5,30,13,0,Matches
236,Dominik Greif,sk SVK,GK,Mallorca,27,1997,31,0,0,0,0,0,0,0,,0,0,0,0,0,0,13,1,Matches
237,Antoine Griezmann,fr FRA,"FW,MF",Atlético Madrid,33,1991,27.4,30,17,13,13,4,7,29,24.1,22,20,1,19,6,36,23,1,Matches
238,Florian Grillitsch,at AUT,MF,Valladolid,28,1995,6.9,11,7,7,3,1,7,15,46.7,8,12,2,10,4,15,5,1,Matches
239,Vicente Guaita,es ESP,GK,Celta Vigo,37,1987,34,0,0,0,0,0,0,0,,0,0,0,0,0,0,21,3,Matches
240,Sergi Guardiola,es ESP,FW,Rayo Vallecano,33,1991,4,5,3,0,5,0,2,3,66.7,1,1,0,1,1,6,2,0,Matches
241,Nemanja Gudelj,rs SRB,"MF,DF",Sevilla,32,1991,27.7,42,24,16,22,4,21,35,60,14,27,10,17,27,69,94,1,Matches
242,Javier Guerra,es ESP,MF,Valencia,21,2003,28.7,50,27,18,21,11,26,56,46.4,30,15,3,12,20,70,49,3,Matches
243,Ander Guevara,es ESP,MF,Alavés,27,1997,21.6,49,30,19,29,1,20,48,41.7,28,21,5,16,14,63,43,1,Matches
244,Pape Gueye,sn SEN,MF,Villarreal,25,1999,24.7,54,26,23,23,8,20,29,69,9,31,13,18,27,81,53,2,Matches
245,Hugo Guillamón,es ESP,MF,Valencia,24,2000,4,11,8,1,9,1,9,10,90,1,4,1,3,5,16,9,1,Matches
246,Carlos Guirao,es ESP,MF,Betis,21,2003,1.2,5,3,1,4,0,4,6,66.7,2,1,1,0,3,8,2,0,Matches
247,Arda Güler,tr TUR,"MF,FW",Real Madrid,19,2005,13.9,30,16,11,8,11,9,22,40.9,13,18,0,18,7,37,8,0,Matches
248,Gerard Gumbau,es ESP,MF,Rayo Vallecano,29,1994,9.4,17,12,8,7,2,7,15,46.7,8,13,4,9,5,22,13,0,Matches
249,Jon Guridi,es ESP,"MF,FW",Alavés,29,1995,23.1,40,22,7,26,7,18,44,40.9,26,19,1,18,14,54,16,0,Matches
250,Gorka Guruzeta,es ESP,FW,Athletic Club,27,1996,20.4,16,8,1,13,2,7,31,22.6,24,28,4,24,9,25,23,0,Matches
251,Miguel Gutiérrez,es ESP,"DF,MF",Girona,23,2001,27.3,37,24,18,16,3,17,37,45.9,20,17,7,10,16,53,34,3,Matches
252,Munir El Haddadi,ma MAR,"FW,MF",Leganés,28,1995,9.6,12,9,5,4,3,3,12,25,9,8,1,7,1,13,1,1,Matches
253,Sébastien Haller,ci CIV,FW,Leganés,30,1994,4.5,2,0,1,0,1,1,2,50,1,1,0,1,0,2,7,0,Matches
254,Henrique,br BRA,DF,Valladolid,30,1994,3.9,6,2,3,2,1,1,4,25,3,5,0,5,3,9,12,0,Matches
255,Javi Hernández,es ESP,DF,Leganés,26,1998,26.5,26,15,16,7,3,17,46,37,29,25,5,20,23,49,98,0,Matches
256,Aridane Hernández,es ESP,DF,Rayo Vallecano,35,1989,11.4,13,11,9,4,0,6,8,75,2,10,8,2,6,19,99,2,Matches
257,Jorge Herrando,es ESP,DF,Osasuna,23,2001,15.2,17,11,9,5,3,9,15,60,6,20,14,6,12,29,65,2,Matches
258,Ander Herrera,es ESP,MF,Athletic Club,34,1989,3,8,4,1,7,0,3,6,50,3,1,0,1,2,10,10,0,Matches
259,Sergio Herrera,es ESP,GK,Osasuna,31,1993,37,2,1,2,0,0,2,6,33.3,4,1,0,1,0,2,29,1,Matches
260,Yangel Herrera,ve VEN,MF,Girona,26,1998,25.1,66,39,31,27,8,30,59,50.8,29,24,8,16,31,97,50,2,Matches
261,Juan Herzog,es ESP,DF,Las Palmas,21,2003,14.6,12,12,12,0,0,9,16,56.3,7,17,11,6,18,30,86,0,Matches
262,Omar El Hilali,ma MAR,DF,Espanyol,20,2003,35,111,79,81,24,6,64,95,67.4,31,53,13,40,46,157,145,2,Matches
263,Roger Hinojo,es ESP,DF,Espanyol,19,2005,0.1,0,0,0,0,0,0,0,,0,0,0,0,0,0,1,0,Matches
264,Dinko Horkaš,hr CRO,GK,Las Palmas,25,1999,12.1,0,0,0,0,0,0,0,,0,0,0,0,0,0,9,1,Matches
265,Pablo Ibáñez,es ESP,MF,Osasuna,25,1998,14.4,20,10,7,12,1,10,40,25,30,20,7,13,18,38,21,0,Matches
266,Stanis Idumbo,be BEL,"FW,MF",Sevilla,19,2005,3.2,9,5,3,4,2,3,5,60,2,3,1,2,4,13,2,0,Matches
267,Iglesias,es ESP,DF,Getafe,26,1998,32.1,81,47,42,33,6,46,90,51.1,44,47,8,39,50,131,133,1,Matches
268,Borja Iglesias,es ESP,FW,Celta Vigo,31,1993,21.7,10,9,2,5,3,4,15,26.7,11,9,2,7,7,17,10,0,Matches
269,Kelechi Iheanacho,ng NGA,FW,Sevilla,27,1996,4.4,1,0,0,1,0,1,3,33.3,2,0,0,0,0,1,1,0,Matches
270,Isco,es ESP,MF,Betis,32,1992,17.2,20,13,3,13,4,7,28,25,21,10,0,10,11,31,7,0,Matches
271,Diego Iturralde,es ESP,FW,Sevilla,21,2003,0.4,0,0,0,0,0,0,0,,0,0,0,0,1,1,1,0,Matches
272,Ivan Jaime Pajuelo,es ESP,MF,Valencia,23,2000,3.3,8,5,2,3,3,4,5,80,1,2,0,2,2,10,0,0,Matches
273,Karl Jakob Hein,ee EST,GK,Valladolid,22,2002,31,0,0,0,0,0,0,2,0,2,0,0,0,0,0,19,2,Matches
274,Adnan Januzaj,be BEL,"MF,FW",Las Palmas,29,1995,6.6,10,6,1,6,3,5,9,55.6,4,6,0,6,2,12,3,0,Matches
275,Mikel Jauregizar,es ESP,MF,Athletic Club,20,2003,24.9,84,48,25,45,14,41,83,49.4,42,24,4,20,29,113,36,2,Matches
276,John Joe,ie IRL,"MF,FW",Getafe,20,2003,0.5,0,0,0,0,0,0,0,,0,1,1,0,0,0,1,0,Matches
277,Jofre,es ESP,"MF,FW",Espanyol,23,2001,24.1,22,16,14,5,3,13,23,56.5,10,13,0,13,15,37,29,0,Matches
278,Frenkie de Jong,nl NED,MF,Barcelona,27,1997,12.7,19,11,5,8,6,8,16,50,8,9,1,8,12,31,7,1,Matches
279,Joan Jordán,es ESP,MF,Alavés,30,1994,15.7,32,18,11,17,4,17,30,56.7,13,12,0,12,9,41,21,0,Matches
280,Juanmi,es ESP,"FW,MF",Getafe,31,1993,7.7,14,11,4,7,3,6,19,31.6,13,6,0,6,2,16,3,0,Matches
281,Juanmi,es ESP,"FW,MF",Betis,31,1993,2.7,7,4,3,3,1,4,6,66.7,2,4,0,4,1,8,4,0,Matches
282,Juanpe,es ESP,DF,Girona,33,1991,8.1,8,5,5,3,0,6,8,75,2,15,10,5,8,16,56,1,Matches
283,Luiz Lúcio Reis Júnior,br BRA,GK,Villarreal,23,2001,16.2,0,0,0,0,0,0,0,,0,0,0,0,0,0,14,1,Matches
284,Vinicius Júnior,br BRA,FW,Real Madrid,24,2000,25,21,10,7,4,10,5,18,27.8,13,9,0,9,3,24,1,2,Matches
285,Stanko Jurić,hr CRO,MF,Valladolid,27,1996,19.2,48,24,26,19,3,19,48,39.6,29,35,11,24,24,72,52,0,Matches
286,Willy Kambwala,fr FRA,DF,Villarreal,19,2004,12.4,17,12,14,2,1,10,12,83.3,2,10,7,3,10,27,56,1,Matches
287,Abdoulaye Keita,es ESP,"FW,MF",Getafe,21,2002,1.1,2,2,0,1,1,2,4,50,2,1,0,1,0,2,3,0,Matches
288,Kenedy,br BRA,"MF,FW",Valladolid,28,1996,0.1,0,0,0,0,0,0,0,,0,1,0,1,0,0,0,0,Matches
289,Kiké,es ESP,FW,Alavés,34,1989,28.2,19,14,1,12,6,6,17,35.3,11,11,4,7,1,20,23,0,Matches
290,Koke,es ESP,MF,Atlético Madrid,32,1992,21.4,46,23,18,22,6,21,43,48.8,22,24,2,22,20,66,29,2,Matches
291,Jules Koundé,fr FRA,DF,Barcelona,25,1998,28.9,63,43,29,23,11,44,66,66.7,22,35,5,30,20,83,68,2,Matches
292,Alex Král,cz CZE,MF,Espanyol,26,1998,30.2,55,37,28,24,3,16,30,53.3,14,34,14,20,28,83,51,2,Matches
293,Ladislav Krejčí,cz CZE,DF,Girona,25,1999,27.1,23,16,19,4,0,14,26,53.8,12,24,19,5,34,57,93,5,Matches
294,Takefusa Kubo,jp JPN,"MF,FW",Real Sociedad,23,2001,26.4,31,20,11,11,9,16,40,40,24,38,1,37,17,48,13,1,Matches
295,Marash Kumbulla,al ALB,DF,Espanyol,24,2000,33,51,26,35,14,2,24,41,58.5,17,48,35,13,34,85,224,2,Matches
296,Luca de la Torre,us USA,MF,Celta Vigo,26,1998,0,0,0,0,0,0,0,0,,0,0,0,0,0,0,0,0,Matches
297,Yoel Lago,es ESP,DF,Celta Vigo,20,2004,6.5,12,8,8,3,1,7,9,77.8,2,5,4,1,4,16,30,0,Matches
298,Cyle Larin,ca CAN,FW,Mallorca,29,1995,19.6,12,6,1,6,5,3,9,33.3,6,12,3,9,1,13,16,0,Matches
299,Juanmi Latasa,es ESP,FW,Valladolid,23,2001,15.5,4,2,1,1,2,2,6,33.3,4,4,1,3,0,4,11,1,Matches
300,Toni Lato,es ESP,DF,Mallorca,26,1997,6.9,17,11,6,5,6,7,11,63.6,4,10,4,6,6,23,33,0,Matches
301,Robin Le Normand,es ESP,DF,Atlético Madrid,27,1996,23.9,27,18,23,4,0,12,20,60,8,20,9,11,10,37,120,1,Matches
302,Florian Lejeune,fr FRA,DF,Rayo Vallecano,33,1991,36.9,46,28,30,14,2,23,43,53.5,20,38,32,6,41,87,181,1,Matches
303,Iñigo Lekue,es ESP,DF,Athletic Club,31,1993,8.6,15,12,12,3,0,9,17,52.9,8,7,2,5,9,24,29,2,Matches
304,Thomas Lemar,fr FRA,MF,Atlético Madrid,28,1995,0.9,2,1,1,1,0,2,4,50,2,0,0,0,0,2,1,0,Matches
305,Clément Lenglet,fr FRA,DF,Atlético Madrid,29,1995,21.9,27,17,19,8,0,11,15,73.3,4,24,18,6,22,49,104,1,Matches
306,Robert Lewandowski,pl POL,FW,Barcelona,35,1988,29.6,10,5,1,5,4,5,11,45.5,6,14,2,12,3,13,26,0,Matches
307,Samuel Lino,br BRA,"MF,DF",Atlético Madrid,24,1999,17.2,33,17,25,4,4,22,52,42.3,30,23,4,19,8,41,13,0,Matches
308,Javier Llabrés,es ESP,FW,Mallorca,21,2002,0.6,0,0,0,0,0,0,0,,0,1,0,1,0,0,0,0,Matches
309,Diego Llorente,es ESP,DF,Betis,30,1993,28,36,20,23,12,1,25,38,65.8,13,29,20,9,43,79,154,1,Matches
310,Marcos Llorente,es ESP,"DF,MF",Atlético Madrid,29,1995,27.9,69,52,38,27,4,36,55,65.5,19,32,7,25,27,96,51,1,Matches
311,Giovani Lo Celso,ar ARG,"MF,FW",Betis,28,1996,16.2,34,22,8,17,9,17,25,68,8,14,2,12,5,39,3,1,Matches
312,Enzo Loiodice,fr FRA,MF,Las Palmas,23,2000,7.6,17,7,8,9,0,3,10,30,7,4,1,3,10,27,7,2,Matches
313,David López,es ESP,DF,Mallorca,21,2003,1.9,3,2,3,0,0,2,2,100,0,2,2,0,1,4,10,0,Matches
314,David López,es ESP,DF,Girona,34,1989,27,32,24,22,7,3,18,31,58.1,13,22,12,10,14,46,111,2,Matches
315,Diego López,es ESP,"MF,FW",Valencia,22,2002,30.4,31,18,11,16,4,16,47,34,31,30,0,30,16,47,15,0,Matches
316,Fer López,,"FW,MF",Celta Vigo,,,7.5,9,5,1,6,2,2,13,15.4,11,10,0,10,2,11,7,0,Matches
317,Fermin López,es ESP,"MF,FW",Barcelona,21,2003,13.9,19,15,3,9,7,8,32,25,24,11,0,11,5,24,3,0,Matches
318,Javi López,es ESP,DF,Real Sociedad,22,2002,21.5,40,23,23,12,5,23,37,62.2,14,21,7,14,11,51,59,2,Matches
319,Pau López,es ESP,GK,Girona,29,1994,0.5,0,0,0,0,0,0,0,,0,0,0,0,0,0,1,0,Matches
320,Roberto López,es ESP,MF,Leganés,24,2000,4.4,8,6,4,4,0,5,15,33.3,10,5,0,5,1,9,7,2,Matches
321,Unai López,es ESP,MF,Rayo Vallecano,28,1995,19,31,21,14,12,5,17,36,47.2,19,18,6,12,21,52,20,0,Matches
322,Iker Losada,es ESP,"FW,MF",Celta Vigo,22,2001,4,3,3,0,1,2,1,5,20,4,4,1,3,1,4,8,0,Matches
323,Iker Losada,es ESP,"MF,FW",Betis,22,2001,3.7,10,7,2,4,4,5,10,50,5,2,0,2,3,13,2,0,Matches
324,Pol Lozano,es ESP,MF,Espanyol,24,1999,21.6,53,34,23,25,5,25,58,43.1,33,32,6,26,22,75,31,0,Matches
325,José Luis Gayà,es ESP,DF,Valencia,29,1995,20,57,40,39,15,3,40,58,69,18,16,2,14,25,82,61,0,Matches
326,Dodi Lukebakio,be BEL,FW,Sevilla,26,1997,34.4,22,14,8,8,6,15,27,55.6,12,18,1,17,11,33,17,2,Matches
327,Daniel Luna,co COL,MF,Mallorca,21,2003,0.2,0,0,0,0,0,0,0,,0,1,0,1,0,0,0,0,Matches
328,Andriy Lunin,ua UKR,GK,Real Madrid,25,1999,7,1,0,1,0,0,0,0,,0,0,0,0,0,1,3,0,Matches
329,Darwin Machís,ve VEN,"MF,FW",Valladolid,31,1993,7.1,5,4,3,2,0,3,9,33.3,6,3,0,3,5,10,13,0,Matches
330,Pablo Maffeo,es ESP,DF,Mallorca,27,1997,26.3,60,40,43,14,3,34,46,73.9,12,32,11,21,25,85,103,1,Matches
331,Jon Magunazelaia,es ESP,MF,Real Sociedad,23,2001,0.1,1,1,1,0,0,0,0,,0,0,0,0,0,1,0,0,Matches
332,Giorgi Mamardashvili,ge GEO,GK,Valencia,23,2000,34,2,2,2,0,0,2,3,66.7,1,0,0,0,1,3,16,3,Matches
333,Reinildo Mandava,mz MOZ,DF,Atlético Madrid,30,1994,10.5,18,11,10,7,1,10,18,55.6,8,11,5,6,16,34,35,0,Matches
334,Javier Manquillo,es ESP,DF,Celta Vigo,30,1994,5.7,7,5,4,3,0,2,10,20,8,5,3,2,7,14,14,0,Matches
335,Marcão,br BRA,DF,Sevilla,28,1996,6.1,10,7,6,4,0,3,5,60,2,9,6,3,7,17,29,1,Matches
336,Óscar de Marcos,es ESP,DF,Athletic Club,35,1989,17.4,32,15,15,13,4,21,37,56.8,16,17,1,16,16,48,35,0,Matches
337,Alberto Marí,es ESP,FW,Valencia,23,2001,0.1,0,0,0,0,0,0,0,,0,0,0,0,0,0,0,0,Matches
338,José María Giménez,uy URU,DF,Atlético Madrid,29,1995,22.2,26,16,18,8,0,17,28,60.7,11,29,19,10,27,53,115,2,Matches
339,Arkaitz Mariezkurrena,es ESP,"FW,MF",Real Sociedad,19,2005,2.7,1,0,1,0,0,0,4,0,4,4,1,3,1,2,4,0,Matches
340,Pablo Marín,es ESP,MF,Real Sociedad,21,2003,13.8,25,17,6,13,6,10,19,52.6,9,12,3,9,5,30,14,0,Matches
341,Mika Mármol,es ESP,DF,Las Palmas,23,2001,26.7,61,29,35,24,2,34,52,65.4,18,46,14,32,38,99,121,2,Matches
342,Mario Maroto,es ESP,MF,Valladolid,20,2003,0.7,0,0,0,0,0,0,2,0,2,0,0,0,2,2,2,0,Matches
343,Unai Marrero,es ESP,GK,Real Sociedad,22,2001,2,0,0,0,0,0,0,0,,0,0,0,0,0,0,1,0,Matches
344,Carlos Martín,es ESP,"FW,MF",Alavés,22,2002,14.8,43,21,18,16,9,13,49,26.5,36,30,1,29,5,48,20,0,Matches
345,Diego Martín,es ESP,FW,Las Palmas,20,2003,0.4,1,1,0,0,1,1,1,100,0,0,0,0,0,1,1,0,Matches
346,Gerard Martín,es ESP,DF,Barcelona,22,2002,11.5,22,10,10,7,5,11,16,68.8,5,16,2,14,13,35,27,0,Matches
347,Iván Martín,es ESP,MF,Girona,25,1999,22.7,32,19,14,14,4,15,34,44.1,19,20,6,14,11,43,15,1,Matches
348,Jon Martin,es ESP,DF,Real Sociedad,18,2006,10,11,9,7,3,1,6,9,66.7,3,13,9,4,7,18,80,1,Matches
349,Mario Martín,es ESP,MF,Valladolid,20,2004,19.4,62,32,31,27,4,21,49,42.9,28,32,7,25,21,83,46,7,Matches
350,Arnau Martinez,es ESP,"DF,MF",Girona,21,2003,29.2,51,28,30,15,6,32,63,50.8,31,18,6,12,31,82,76,2,Matches
351,Iñigo Martínez,es ESP,DF,Barcelona,33,1991,27.7,25,14,20,5,0,16,22,72.7,6,18,7,11,18,43,108,1,Matches
352,Javi Martínez,es ESP,MF,Osasuna,24,1999,0.1,0,0,0,0,0,0,0,,0,0,0,0,0,0,0,0,Matches
353,Ramón Martínez,es ESP,DF,Sevilla,21,2002,2.9,6,3,5,1,0,3,5,60,2,2,1,1,2,8,23,0,Matches
354,Toni Martínez,es ESP,FW,Alavés,27,1997,11.2,12,7,5,4,3,4,8,50,4,8,2,6,1,13,15,0,Matches
355,Javi Martón,es ESP,"FW,MF",Athletic Club,25,1999,0.6,0,0,0,0,0,0,0,,0,0,0,0,0,0,0,0,Matches
356,Marvin,es ESP,"DF,FW",Las Palmas,24,2000,11.5,25,13,12,9,4,11,26,42.3,15,17,6,11,15,40,34,0,Matches
357,Omar Mascarell,gq EQG,MF,Mallorca,31,1993,22.1,27,13,13,13,1,14,35,40,21,33,21,12,49,76,59,3,Matches
358,Jaime Mata,es ESP,"FW,MF",Las Palmas,35,1988,7.3,8,2,2,6,0,3,9,33.3,6,5,1,4,3,11,11,0,Matches
359,Borja Mayoral,es ESP,FW,Getafe,27,1997,12.4,5,4,2,2,1,3,9,33.3,6,4,0,4,2,7,6,0,Matches
360,Kylian Mbappé,fr FRA,FW,Real Madrid,25,1998,32.3,8,5,1,3,4,1,5,20,4,3,0,3,1,9,1,1,Matches
361,Oliver McBurnie,sct SCO,FW,Las Palmas,28,1996,20.4,15,7,5,8,2,5,12,41.7,7,15,5,10,6,21,24,0,Matches
362,Scott McKenna,sct SCO,DF,Las Palmas,27,1996,27.4,21,13,16,5,0,9,12,75,3,36,28,8,9,30,163,2,Matches
363,Mateo Mejía,es ESP,FW,Sevilla,21,2003,0.1,0,0,0,0,0,0,0,,0,0,0,0,0,0,0,0,Matches
364,Arthur Melo,br BRA,MF,Girona,27,1996,10.5,25,11,8,12,5,14,27,51.9,13,5,1,4,8,33,12,1,Matches
365,Brais Méndez,es ESP,MF,Real Sociedad,27,1997,17,24,13,6,14,4,9,24,37.5,15,14,1,13,7,31,16,1,Matches
366,Ferland Mendy,fr FRA,DF,Real Madrid,29,1995,11.2,17,14,7,6,4,9,12,75,3,11,4,7,9,26,8,1,Matches
367,Nobel Mendy,fr FRA,DF,Betis,19,2004,1.2,0,0,0,0,0,0,0,,0,2,0,2,4,4,10,1,Matches
368,Víctor Meseguer,es ESP,MF,Valladolid,25,1999,4.6,10,6,4,4,2,2,10,20,8,3,0,3,2,12,4,1,Matches
369,Miguel,es ESP,FW,Leganés,24,1999,19.2,16,7,6,4,6,4,14,28.6,10,15,4,11,4,20,23,1,Matches
370,Éder Militão,br BRA,DF,Real Madrid,26,1998,10.4,19,17,14,5,0,7,12,58.3,5,13,8,5,12,31,35,0,Matches
371,Luis Milla,es ESP,MF,Getafe,29,1994,31.9,61,40,28,25,8,35,72,48.6,37,25,0,25,24,85,28,3,Matches
372,Pere Milla,es ESP,"MF,FW",Espanyol,31,1992,5.1,6,2,5,0,1,1,18,5.6,17,10,2,8,3,9,5,0,Matches
373,Óscar Mingueza,es ESP,"MF,DF",Celta Vigo,25,1999,30.3,38,24,21,12,5,26,69,37.7,43,35,5,30,22,60,46,7,Matches
374,Kim Minsu,kr KOR,"MF,FW",Girona,18,2006,0.2,1,0,0,1,0,0,0,,0,0,0,0,0,1,0,0,Matches
375,Bojan Miovski,mk MKD,FW,Girona,25,1999,9.7,7,5,2,2,3,2,7,28.6,5,4,0,4,2,9,7,0,Matches
376,Rafa Mir,es ESP,"FW,MF",Valencia,27,1997,8.4,12,6,8,4,0,3,9,33.3,6,5,0,5,5,17,9,0,Matches
377,Luka Modrić,hr CRO,MF,Real Madrid,38,1985,20.3,31,20,16,13,2,14,32,43.8,18,17,5,12,27,58,17,0,Matches
378,Johan Mojica,co COL,DF,Mallorca,31,1992,30.6,35,23,26,6,3,19,40,47.5,21,13,5,8,26,61,84,3,Matches
379,Alberto Moleiro,es ESP,"FW,MF",Las Palmas,20,2003,30.2,27,12,12,14,1,18,48,37.5,30,24,0,24,18,45,8,0,Matches
380,Nahuel Molina,ar ARG,DF,Atlético Madrid,26,1998,17.7,44,19,21,21,2,31,56,55.4,25,16,3,13,13,57,53,0,Matches
381,Jon Moncayola,es ESP,MF,Osasuna,26,1998,23.3,70,41,29,33,8,31,60,51.7,29,34,3,31,11,81,20,0,Matches
382,Gonzalo Montiel,ar ARG,"DF,MF",Sevilla,27,1997,1.3,4,2,3,1,0,3,4,75,1,0,0,0,2,6,11,0,Matches
383,Gerard Moreno,es ESP,FW,Villarreal,32,1992,8,7,4,3,2,2,3,12,25,9,0,0,0,2,9,8,0,Matches
384,Xavier Moreno,es ESP,FW,Valladolid,19,2004,0.5,0,0,0,0,0,0,0,,0,0,0,0,0,0,1,0,Matches
385,Mateu Morey,es ESP,DF,Mallorca,24,2000,8.2,22,18,13,6,3,12,22,54.5,10,11,0,11,15,37,32,2,Matches
386,Ilaix Moriba,gn GUI,MF,Celta Vigo,21,2003,23.7,68,42,24,30,14,32,57,56.1,25,29,4,25,14,82,33,1,Matches
387,Manu Morlanes,es ESP,MF,Mallorca,25,1999,14.9,43,27,18,20,5,18,30,60,12,19,8,11,24,67,16,0,Matches
388,Raúl Moro,es ESP,"MF,FW",Valladolid,21,2002,26,22,13,15,4,3,13,32,40.6,19,8,0,8,10,32,20,1,Matches
389,Cristhian Mosquera,es ESP,DF,Valencia,20,2004,36.9,56,36,41,13,2,31,40,77.5,9,37,24,13,35,91,128,4,Matches
390,Santiago Mouriño,uy URU,DF,Alavés,22,2002,20.5,43,28,31,12,0,21,38,55.3,17,27,12,15,29,72,120,0,Matches
391,Abdul Mumin,gh GHA,DF,Rayo Vallecano,26,1998,22.4,37,25,30,7,0,17,27,63,10,40,29,11,23,60,125,0,Matches
392,Aihen Muñoz,es ESP,DF,Real Sociedad,26,1997,12.2,24,12,14,8,2,14,28,50,14,11,6,5,14,38,47,0,Matches
393,Álex Muñoz,es ESP,DF,Las Palmas,30,1994,15.7,39,29,22,16,1,21,38,55.3,17,28,11,17,16,55,69,0,Matches
394,Iker Muñoz,es ESP,MF,Osasuna,21,2002,6.8,5,2,3,2,0,3,9,33.3,6,9,2,7,4,9,12,1,Matches
395,Javier Muñoz,es ESP,"MF,DF",Las Palmas,29,1995,28.8,45,35,18,17,10,16,46,34.8,30,27,4,23,31,76,39,3,Matches
396,Víctor Muñoz,es ESP,"FW,DF",Real Madrid,21,2003,0.4,0,0,0,0,0,0,0,,0,0,0,0,0,0,0,0,Matches
397,Vedat Muriqi,xk KVX,FW,Mallorca,30,1994,22.9,7,5,3,2,2,3,7,42.9,4,7,1,6,7,14,43,0,Matches
398,Juan Musso,ar ARG,GK,Atlético Madrid,30,1994,2,0,0,0,0,0,0,0,,0,0,0,0,0,0,0,0,Matches
399,Matija Nastasić,rs SRB,DF,Leganés,31,1993,23.4,25,11,21,4,0,17,25,68,8,39,30,9,21,46,165,0,Matches
400,Natan,br BRA,DF,Betis,23,2001,24.2,35,24,24,9,2,26,30,86.7,4,24,14,10,28,63,123,2,Matches
401,Pau Navarro,es ESP,DF,Villarreal,19,2005,10.2,23,17,15,6,2,19,39,48.7,20,13,6,7,4,27,41,0,Matches
402,Roberto Navarro,es ESP,"MF,FW",Mallorca,22,2002,14.2,29,22,14,11,4,9,19,47.4,10,18,0,18,19,48,12,0,Matches
403,Jesús Navas,es ESP,"FW,MF",Sevilla,38,1985,4.7,5,2,3,0,2,0,3,0,3,1,0,1,4,9,6,0,Matches
404,Yvan Neyou,cm CMR,MF,Leganés,27,1997,25.7,53,33,21,26,6,22,47,46.8,25,35,5,30,26,79,38,1,Matches
405,Tanguy Nianzou,fr FRA,DF,Sevilla,22,2002,5.8,7,5,6,0,1,5,6,83.3,1,1,0,1,8,15,27,0,Matches
406,Saúl Ñíguez,es ESP,MF,Sevilla,29,1994,17.3,47,32,16,24,7,12,31,38.7,19,25,2,23,22,69,34,0,Matches
407,Tamás Nikitscher,hu HUN,"MF,DF",Valladolid,24,1999,9.5,17,8,8,9,0,8,13,61.5,5,17,4,13,11,28,16,1,Matches
408,Adrian Niño,es ESP,FW,Atlético Madrid,20,2004,0.1,0,0,0,0,0,0,0,,0,0,0,0,0,0,0,0,Matches
409,Hugo Novoa,es ESP,"DF,MF",Alavés,21,2003,2.6,8,5,4,3,1,5,5,100,0,2,1,1,0,8,6,0,Matches
410,Randy Nteka,ao ANG,FW,Rayo Vallecano,26,1997,12.5,16,5,3,9,4,5,12,41.7,7,13,2,11,4,20,20,0,Matches
411,Unai Núñez,es ESP,DF,Athletic Club,27,1997,7.2,10,5,7,3,0,4,7,57.1,3,4,4,0,17,27,46,1,Matches
412,Ørjan Nyland,no NOR,GK,Sevilla,33,1990,29.7,3,2,3,0,0,3,5,60,2,0,0,0,0,3,12,4,Matches
413,Allan Nyom,cm CMR,"DF,MF",Getafe,36,1988,9.9,18,11,7,9,2,15,17,88.2,2,4,2,2,4,22,23,0,Matches
414,Jan Oblak,si SVN,GK,Atlético Madrid,31,1993,36,0,0,0,0,0,0,0,,0,0,0,0,0,0,17,2,Matches
415,Lucas Ocampos,ar ARG,FW,Sevilla,30,1994,1.9,3,2,2,0,1,1,2,50,1,2,0,2,0,3,2,0,Matches
416,Álvaro Odriozola,es ESP,DF,Real Sociedad,28,1995,0.5,1,1,1,0,0,0,0,,0,0,0,0,0,1,1,0,Matches
417,Thiago Ojeda,ar ARG,MF,Villarreal,21,2003,0.1,0,0,0,0,0,0,0,,0,0,0,0,0,0,1,0,Matches
418,Aingeru Olabarrieta,es ESP,FW,Athletic Club,18,2005,0.6,0,0,0,0,0,0,0,,0,2,0,2,1,1,1,0,Matches
419,Olasagasti,es ESP,MF,Real Sociedad,23,2000,9.5,21,10,7,9,5,8,18,44.4,10,8,2,6,15,36,10,0,Matches
420,Brian Oliván,es ESP,DF,Espanyol,30,1994,11.3,13,10,7,6,0,4,13,30.8,9,6,2,4,10,23,23,0,Matches
421,Lucas Oliveira Rosa,br BRA,DF,Valladolid,24,2000,21,53,33,40,11,2,35,51,68.6,16,24,9,15,28,81,69,2,Matches
422,Dani Olmo,es ESP,"MF,FW",Barcelona,26,1998,13.5,16,11,8,5,3,4,14,28.6,10,6,3,3,3,19,11,1,Matches
423,Aimar Oroz,es ESP,MF,Osasuna,22,2001,33,35,19,16,13,6,14,46,30.4,32,29,2,27,20,55,10,0,Matches
424,Ángel Ortíz,es ESP,DF,Betis,20,2004,3.9,12,8,8,3,1,8,17,47.1,9,6,0,6,5,17,7,0,Matches
425,Gabriel Osei Misehouy,nl NED,"FW,MF",Girona,19,2005,2.9,1,1,0,1,0,0,1,0,1,0,0,0,0,1,0,0,Matches
426,David Otorbi,es ESP,MF,Valencia,16,2007,0.2,0,0,0,0,0,0,0,,0,1,0,1,0,0,0,0,Matches
427,Jesús Owono,gq EQG,GK,Alavés,23,2001,5.4,1,1,1,0,0,1,1,100,0,0,0,0,0,1,2,0,Matches
428,Mikel Oyarzabal,es ESP,FW,Real Sociedad,27,1997,25,25,16,9,10,6,10,23,43.5,13,17,1,16,4,29,15,0,Matches
429,Cenk Özkacar,tr TUR,DF,Valladolid,23,2000,8.4,9,5,7,2,0,4,14,28.6,10,9,6,3,18,27,69,1,Matches
430,Jon Pacheco,es ESP,DF,Real Sociedad,23,2001,9.5,15,9,12,3,0,10,12,83.3,2,8,6,2,9,24,49,2,Matches
431,Alex Padilla,es ESP,GK,Athletic Club,20,2003,3.6,0,0,0,0,0,0,0,,0,0,0,0,0,0,2,1,Matches
432,Isaac Palazón Camacho,es ESP,"MF,FW",Rayo Vallecano,29,1994,24,22,17,10,6,6,8,34,23.5,26,22,3,19,8,30,13,1,Matches
433,Aitor Paredes,es ESP,DF,Athletic Club,24,2000,20.1,15,13,10,5,0,8,15,53.3,7,26,15,11,22,37,114,4,Matches
434,Daniel Parejo,es ESP,MF,Villarreal,35,1989,25.3,52,40,27,20,5,29,54,53.7,25,24,7,17,24,76,40,1,Matches
435,Iago Parente,es ESP,DF,Valladolid,18,2006,0.8,0,0,0,0,0,0,0,,0,0,0,0,0,0,2,0,Matches
436,Álvaro Pascual,es ESP,FW,Sevilla,22,2002,4.5,5,3,0,3,2,1,5,20,4,4,0,4,2,7,9,0,Matches
437,Alfonso Pedraza,es ESP,"DF,MF",Villarreal,28,1996,5.1,3,2,2,0,1,2,4,50,2,3,1,2,6,9,16,0,Matches
438,Pedri,es ESP,MF,Barcelona,21,2002,32,61,34,14,38,9,24,70,34.3,46,45,3,42,26,87,21,1,Matches
439,Adrià Pedrosa,es ESP,DF,Sevilla,26,1998,25.5,56,32,34,16,6,31,54,57.4,23,43,11,32,24,80,85,0,Matches
440,Pejiño,es ESP,FW,Las Palmas,28,1996,0.2,1,1,0,1,0,1,1,100,0,0,0,0,0,1,0,0,Matches
441,Andy Pelmard,fr FRA,DF,Las Palmas,24,2000,2.3,5,0,3,2,0,4,5,80,1,3,1,2,2,7,20,0,Matches
442,Iñaki Peña,es ESP,GK,Barcelona,25,1999,15.5,0,0,0,0,0,0,2,0,2,0,0,0,0,0,20,1,Matches
443,Rubén Peña,es ESP,"FW,DF",Osasuna,33,1991,8.6,12,5,4,3,5,5,24,20.8,19,11,0,11,6,18,12,0,Matches
444,Nicolas Pépé,ci CIV,"FW,MF",Villarreal,29,1995,16.7,22,9,12,6,4,6,17,35.3,11,12,1,11,5,27,12,0,Matches
445,Peque,es ESP,"MF,FW",Sevilla,21,2002,12.6,16,5,4,10,2,7,17,41.2,10,16,0,16,8,24,5,0,Matches
446,Ayoze Pérez,es ESP,FW,Villarreal,31,1993,21.9,27,14,5,18,4,6,24,25,18,17,0,17,8,35,15,0,Matches
447,Carles Pérez,es ESP,"MF,FW",Getafe,26,1998,15.9,33,23,11,14,8,21,48,43.8,27,19,2,17,6,39,22,0,Matches
448,Francisco Perez,es ESP,"FW,MF",Valencia,21,2002,6.3,17,12,7,8,2,10,16,62.5,6,8,1,7,3,20,6,0,Matches
449,Kike Pérez,es ESP,MF,Valladolid,27,1997,13.2,37,26,15,19,3,15,26,57.7,11,16,4,12,7,44,18,0,Matches
450,Luis Pérez,es ESP,DF,Valladolid,29,1995,28.4,41,30,25,11,5,24,40,60,16,26,9,17,29,70,86,0,Matches
451,Romain Perraud,fr FRA,DF,Betis,26,1997,22.2,36,22,15,16,5,21,46,45.7,25,18,4,14,22,58,71,1,Matches
452,Valentín Pezzolesi,es ESP,DF,Las Palmas,17,2007,0.1,0,0,0,0,0,0,0,,0,0,0,0,0,0,1,1,Matches
453,Pica,es ESP,DF,Alavés,22,2002,5.5,9,7,7,2,0,4,9,44.4,5,7,6,1,9,18,26,0,Matches
454,Yeremi Pino,es ESP,"MF,FW",Villarreal,21,2002,21.5,60,32,20,32,8,32,65,49.2,33,38,3,35,8,68,18,0,Matches
455,Portu,es ESP,"FW,MF",Girona,32,1992,8.7,13,7,5,5,3,7,10,70,3,8,0,8,0,13,2,0,Matches
456,Beñat Prados,es ESP,MF,Athletic Club,23,2001,19.1,55,36,20,27,8,25,53,47.2,28,21,2,19,28,83,26,0,Matches
457,Abdón Prats,es ESP,"FW,MF",Mallorca,31,1992,5.1,2,1,1,1,0,1,2,50,1,2,1,1,1,3,5,0,Matches
458,Javi Puado,es ESP,"FW,MF",Espanyol,26,1998,33,22,17,14,4,4,8,20,40,12,18,3,15,5,27,19,0,Matches
459,Dani Raba,es ESP,"FW,MF",Leganés,28,1995,20.9,37,23,17,15,5,17,42,40.5,25,27,3,24,14,51,19,1,Matches
460,Arnau Rafús,es ESP,GK,Valladolid,21,2003,1,0,0,0,0,0,0,0,,0,0,0,0,0,0,0,1,Matches
461,Antonio Raillo,es ESP,DF,Mallorca,32,1991,35.6,31,18,18,10,3,14,20,70,6,51,38,13,29,60,222,1,Matches
462,Benito Ramírez,es ESP,"DF,FW",Las Palmas,29,1995,5.3,10,5,4,6,0,9,16,56.3,7,8,3,5,1,11,14,1,Matches
463,Sandro Ramírez,es ESP,"FW,MF",Las Palmas,29,1995,22.6,27,15,10,13,4,13,30,43.3,17,20,0,20,16,43,22,2,Matches
464,Jacobo Ramón,es ESP,DF,Real Madrid,19,2005,2.3,7,3,4,3,0,2,2,100,0,1,0,1,3,10,8,2,Matches
465,Raphinha,br BRA,"FW,MF",Barcelona,27,1996,31.5,36,22,6,19,11,19,39,48.7,20,29,2,27,11,47,26,0,Matches
466,Andrei Ratiu,ro ROU,DF,Rayo Vallecano,26,1998,34.1,71,41,40,21,10,42,70,60,28,45,5,40,27,98,73,2,Matches
467,Raúl,es ESP,"FW,MF",Osasuna,23,2000,8.3,13,8,3,6,4,5,10,50,5,4,0,4,0,13,6,0,Matches
468,Abderrahman Rebbach,dz ALG,"FW,MF",Alavés,25,1998,4.3,3,2,3,0,0,0,6,0,6,4,0,4,0,3,6,0,Matches
469,Álex Remiro,es ESP,GK,Real Sociedad,29,1995,36,1,0,1,0,0,1,2,50,1,0,0,0,0,1,18,4,Matches
470,Daniel Requena,es ESP,MF,Villarreal,20,2004,0.1,0,0,0,0,0,0,0,,0,0,0,0,0,0,0,0,Matches
471,Diego Rico,es ESP,DF,Getafe,31,1993,31.3,81,49,47,29,5,47,85,55.3,38,41,3,38,34,115,102,2,Matches
472,Luis Rioja,es ESP,FW,Alavés,30,1993,0.3,2,1,0,1,1,1,2,50,1,2,0,2,0,2,0,0,Matches
473,Luis Rioja,es ESP,"MF,FW",Valencia,30,1993,31.5,33,21,14,12,7,14,42,33.3,28,30,1,29,22,55,44,1,Matches
474,Rodrigo Riquelme,es ESP,"MF,DF",Atlético Madrid,24,2000,5.7,11,5,4,6,1,6,11,54.5,5,3,0,3,2,13,3,0,Matches
475,Alberto Risco,es ESP,"MF,FW",Getafe,18,2005,0.8,4,4,2,0,2,1,6,16.7,5,2,0,2,0,4,0,0,Matches
476,Mihailo Ristić,rs SRB,"DF,MF",Celta Vigo,28,1995,4.8,7,7,4,2,1,4,6,66.7,2,1,0,1,2,9,18,0,Matches
477,Gorka Rivera Alonso,es ESP,"DF,MF",Getafe,19,2004,0.2,2,0,0,2,0,2,2,100,0,0,0,0,0,2,0,0,Matches
478,Marc Roca,es ESP,MF,Betis,27,1996,10.1,20,14,10,9,1,9,17,52.9,8,17,5,12,14,34,14,2,Matches
479,Rodri,es ESP,FW,Betis,24,2000,1.3,2,1,1,1,0,1,2,50,1,2,1,1,1,3,1,1,Matches
480,Adrian Rodriguez,es ESP,GK,Alavés,23,2000,1.4,0,0,0,0,0,0,1,0,1,0,0,0,0,0,3,1,Matches
481,Álvaro Rodríguez,uy URU,FW,Getafe,20,2004,9.5,10,7,0,7,3,5,10,50,5,23,0,23,3,13,12,0,Matches
482,Óscar Rodríguez Arnaiz,es ESP,"MF,FW",Leganés,26,1998,14.8,32,17,10,16,6,14,32,43.8,18,10,1,9,20,52,20,0,Matches
483,Arturo Rodríguez,es ESP,FW,Las Palmas,17,2006,0.2,0,0,0,0,0,0,0,,0,0,0,0,0,0,0,0,Matches
484,Damián Rodríguez,es ESP,MF,Celta Vigo,21,2003,10.3,14,9,3,10,1,6,16,37.5,10,6,1,5,7,21,13,0,Matches
485,Dani Rodríguez,es ESP,"MF,FW",Mallorca,36,1988,24,49,29,18,21,10,14,27,51.9,13,22,3,19,12,61,30,0,Matches
486,Daniel Rodriguez,es ESP,FW,Barcelona,18,2005,0.4,0,0,0,0,0,0,0,,0,1,0,1,0,0,0,0,Matches
487,James Rodríguez,co COL,"MF,FW",Rayo Vallecano,33,1991,1.6,3,2,1,2,0,0,2,0,2,2,0,2,1,4,0,0,Matches
488,Javi Rodríguez,es ESP,DF,Celta Vigo,21,2003,27.9,53,38,35,17,1,33,47,70.2,14,29,10,19,33,86,96,2,Matches
489,Jesus Rodríguez,es ESP,FW,Betis,18,2005,12.3,16,14,6,6,4,5,18,27.8,13,16,0,16,6,22,3,0,Matches
490,Kirian Rodríguez,es ESP,MF,Las Palmas,28,1996,19.5,33,17,12,18,3,22,43,51.2,21,22,4,18,10,43,21,0,Matches
491,Ricardo Rodríguez,ch SUI,DF,Betis,31,1992,14.2,28,15,16,5,7,17,26,65.4,9,10,1,9,8,36,51,0,Matches
492,Rodrygo,br BRA,"FW,MF",Real Madrid,23,2001,21.4,21,14,14,5,2,7,23,30.4,16,18,1,17,11,32,9,0,Matches
493,Leo Román,es ESP,GK,Mallorca,24,2000,7,0,0,0,0,0,0,0,,0,0,0,0,0,0,6,0,Matches
494,Carlos Romero,es ESP,DF,Espanyol,22,2001,28.4,73,47,49,16,8,45,82,54.9,37,50,15,35,30,103,102,1,Matches
495,Isaac Romero,es ESP,FW,Sevilla,24,2000,24,13,7,4,4,5,3,16,18.8,13,18,1,17,7,20,27,0,Matches
496,Luka Romero,ar ARG,"FW,MF",Alavés,19,2004,2.2,4,4,1,1,2,2,3,66.7,1,2,0,2,1,5,0,0,Matches
497,Oriol Romeu,es ESP,MF,Girona,32,1991,15.1,38,25,14,19,5,14,26,53.8,12,22,8,14,12,50,20,4,Matches
498,Vitor Roque,br BRA,FW,Betis,19,2005,13.7,11,6,1,6,4,1,5,20,4,5,0,5,7,18,4,0,Matches
499,Valentin Rosier,fr FRA,DF,Leganés,27,1996,28.8,72,52,48,16,8,43,68,63.2,25,40,15,25,52,124,149,2,Matches
500,Antonio Rüdiger,de GER,DF,Real Madrid,31,1993,25.5,20,13,14,6,0,11,15,73.3,4,22,14,8,9,29,96,1,Matches
501,Aitor Ruibal,es ESP,"DF,FW",Betis,28,1996,14.6,32,23,22,4,6,25,47,53.2,22,20,5,15,14,46,40,1,Matches
502,Abel Ruiz,es ESP,FW,Girona,24,2000,15,6,2,2,2,2,2,5,40,3,7,2,5,5,11,7,0,Matches
503,Ferrán Ruiz,es ESP,MF,Girona,21,2003,0.2,0,0,0,0,0,0,0,,0,2,1,1,1,1,0,0,Matches
504,Youssouf Sabaly,sn SEN,DF,Betis,31,1993,17.6,40,25,21,15,4,24,32,75,8,21,4,17,13,53,40,0,Matches
505,Umar Sadiq,ng NGA,FW,Valencia,27,1997,9.2,10,5,3,5,2,4,6,66.7,2,7,0,7,1,11,7,0,Matches
506,Umar Sadiq,ng NGA,FW,Real Sociedad,27,1997,2.5,2,1,1,1,0,1,2,50,1,3,1,2,1,3,2,0,Matches
507,Jorge Sáenz,es ESP,DF,Leganés,27,1996,18.8,37,23,18,18,1,11,20,55,9,26,17,9,25,62,161,0,Matches
508,Jan Salas,es ESP,"MF,FW",Mallorca,18,2005,0.5,3,1,2,1,0,2,2,100,0,0,0,0,0,3,0,0,Matches
509,Kike Salas,es ESP,DF,Sevilla,22,2002,24.9,47,28,24,16,7,27,46,58.7,19,26,14,12,32,79,146,0,Matches
510,Albert Sambi Lokonga,be BEL,MF,Sevilla,24,1999,16.3,22,15,10,9,3,10,14,71.4,4,13,1,12,9,31,24,3,Matches
511,Chuky san jose,es ESP,MF,Valladolid,20,2004,8.1,8,2,3,3,2,2,9,22.2,7,4,1,3,0,8,4,0,Matches
512,Oihan Sancet,es ESP,MF,Athletic Club,24,2000,18,13,8,6,6,1,5,14,35.7,9,10,0,10,5,18,6,0,Matches
513,Antonio Sánchez,es ESP,"MF,DF",Mallorca,27,1997,15.5,28,16,16,8,4,14,36,38.9,22,16,2,14,18,46,36,1,Matches
514,Iván Sánchez,es ESP,"MF,FW",Valladolid,31,1992,15.6,37,20,18,10,9,12,27,44.4,15,18,3,15,14,51,10,0,Matches
515,Javi Sánchez,es ESP,DF,Valladolid,27,1997,22.5,26,16,19,6,1,17,26,65.4,9,39,28,11,22,48,111,3,Matches
516,Juanlu Sánchez,es ESP,"MF,DF",Sevilla,20,2003,19.1,50,34,28,15,7,35,59,59.3,24,27,2,25,17,67,19,0,Matches
517,Manu Sánchez,es ESP,DF,Alavés,23,2000,29.3,83,56,40,33,10,41,69,59.4,28,51,12,39,30,113,76,1,Matches
518,Maroan Sannadi,es ESP,FW,Athletic Club,23,2001,8.4,5,0,1,4,0,2,7,28.6,5,1,0,1,1,6,2,1,Matches
519,Jesús Santiago,es ESP,MF,Getafe,20,2004,4.1,14,8,6,8,0,5,10,50,5,6,2,4,1,15,3,0,Matches
520,Aleksandar Sedlar,rs SRB,DF,Alavés,32,1991,6.6,18,10,7,11,0,8,10,80,2,2,1,1,10,28,24,1,Matches
521,Sergi,es ESP,DF,Leganés,32,1992,32.9,40,29,22,16,2,18,32,56.3,14,38,29,9,39,79,185,2,Matches
522,Nicolás Serrano,es ESP,FW,Athletic Club,21,2003,1.2,1,1,0,1,0,1,3,33.3,2,4,0,4,1,2,1,0,Matches
523,Fábio Silva,pt POR,FW,Las Palmas,22,2002,20.7,12,7,4,5,3,4,14,28.6,10,12,0,12,4,16,27,0,Matches
524,Rui Silva,pt POR,GK,Betis,30,1994,15,0,0,0,0,0,0,1,0,1,1,0,1,0,0,7,0,Matches
525,Giuliano Simeone,ar ARG,MF,Atlético Madrid,21,2002,21.4,27,13,6,11,10,15,30,50,15,22,3,19,14,41,22,1,Matches
526,Unai Simón,es ESP,GK,Athletic Club,27,1997,21,0,0,0,0,0,0,0,,0,1,0,1,1,1,14,4,Matches
527,Daley Sinkgraven,nl NED,DF,Las Palmas,29,1995,1,5,1,3,2,0,1,3,33.3,2,1,0,1,1,6,2,0,Matches
528,Jailson Siqueira,br BRA,"DF,MF",Celta Vigo,28,1995,6.8,13,11,9,3,1,9,11,81.8,2,6,4,2,9,22,28,1,Matches
529,Antonio Sivera,es ESP,GK,Alavés,27,1996,31.2,2,1,2,0,0,2,2,100,0,1,0,1,0,2,20,0,Matches
530,Justin Smith,ca CAN,MF,Espanyol,21,2003,2.3,9,3,3,6,0,4,6,66.7,2,5,1,4,4,13,3,0,Matches
531,Alex Sola,es ESP,"MF,FW",Getafe,25,1999,11.4,21,14,9,12,0,9,25,36,16,8,0,8,7,28,11,1,Matches
532,Arnau Solà,es ESP,MF,Villarreal,21,2003,0.1,0,0,0,0,0,0,2,0,2,1,1,0,0,0,0,0,Matches
533,Jhon Solis,co COL,MF,Girona,19,2004,5.9,13,7,3,9,1,6,14,42.9,8,13,1,12,4,17,6,1,Matches
534,David Soria,es ESP,GK,Getafe,31,1993,38,4,4,4,0,0,4,5,80,1,0,0,0,1,5,21,3,Matches
535,Juan Soriano,es ESP,GK,Leganés,26,1997,6,1,1,1,0,0,1,1,100,0,0,0,0,0,1,2,0,Matches
536,Hugo Sotelo,es ESP,MF,Celta Vigo,20,2003,13.9,28,17,8,10,10,13,31,41.9,18,9,1,8,5,33,9,1,Matches
537,Djibril Sow,ch SUI,MF,Sevilla,27,1997,22.9,25,14,13,10,2,8,17,47.1,9,18,3,15,28,53,26,1,Matches
538,Carl Starfelt,se SWE,DF,Celta Vigo,29,1995,25.2,40,20,25,14,1,18,27,66.7,9,29,21,8,31,71,129,3,Matches
539,Orri Steinn Óskarsson,is ISL,FW,Real Sociedad,19,2004,10.5,6,6,2,1,3,2,8,25,6,10,1,9,2,8,11,0,Matches
540,Stoichkov,es ESP,"MF,FW",Alavés,30,1993,7.8,14,9,6,7,1,6,11,54.5,5,2,0,2,1,15,7,0,Matches
541,Cristhian Stuani,uy URU,FW,Girona,37,1986,12,9,7,1,7,1,5,8,62.5,3,4,1,3,7,16,11,0,Matches
542,Álex Suárez,es ESP,DF,Las Palmas,31,1993,27.3,40,23,30,9,1,20,27,74.1,7,39,24,15,13,53,107,2,Matches
543,Denis Suárez,es ESP,MF,Villarreal,30,1994,6.8,12,8,7,2,3,4,10,40,6,4,1,3,3,15,3,0,Matches
544,Luka Sučić,hr CRO,MF,Real Sociedad,21,2002,19.9,25,18,8,12,5,10,26,38.5,16,30,2,28,15,40,16,1,Matches
545,Suso,es ESP,"FW,MF",Sevilla,30,1993,6.7,10,7,3,6,1,4,11,36.4,7,4,0,4,4,14,2,0,Matches
546,Williot Swedberg,se SWE,"FW,MF",Celta Vigo,20,2004,15,23,16,9,10,4,13,20,65,7,12,1,11,3,26,10,1,Matches
547,Mamadou Sylla,sn SEN,"FW,MF",Valladolid,30,1994,17.6,8,4,3,3,2,2,9,22.2,7,8,0,8,3,11,14,1,Matches
548,Wojciech Szczęsny,pl POL,GK,Barcelona,34,1990,15,1,1,1,0,0,0,0,,0,0,0,0,0,1,20,1,Matches
549,Alexander Sørloth,no NOR,FW,Atlético Madrid,28,1995,17.4,9,5,2,5,2,3,6,50,3,6,1,5,1,10,28,0,Matches
550,Renato Tapia,pe PER,"MF,DF",Leganés,29,1995,26.9,61,35,30,27,4,24,50,48,26,58,23,35,27,88,86,2,Matches
551,César Tárrega,es ESP,DF,Valencia,22,2002,33.6,49,37,33,13,3,19,31,61.3,12,41,20,21,22,71,222,2,Matches
552,Aurélien Tchouaméni,fr FRA,"DF,MF",Real Madrid,24,2000,29.9,47,23,25,19,3,21,41,51.2,20,34,25,9,46,93,92,1,Matches
553,Álvaro Tejero,es ESP,"MF,DF",Espanyol,28,1996,13.8,14,4,7,6,1,7,23,30.4,16,9,1,8,13,27,34,1,Matches
554,Martín Tejón,es ESP,"MF,DF",Valencia,20,2004,0.5,2,0,0,2,0,1,2,50,1,0,0,0,0,2,0,0,Matches
555,Nahuel Tenaglia,ar ARG,DF,Alavés,28,1996,32.5,96,61,61,30,5,53,88,60.2,35,33,9,24,47,143,123,2,Matches
556,Marc-André ter Stegen,de GER,GK,Barcelona,32,1992,7.5,0,0,0,0,0,0,1,0,1,0,0,0,0,0,2,2,Matches
557,Ramón Terrats,es ESP,"MF,FW",Villarreal,23,2000,1.5,3,3,1,2,0,2,4,50,2,3,1,2,2,5,3,0,Matches
558,Ramón Terrats,es ESP,"MF,FW",Getafe,23,2000,13.5,20,10,7,8,5,8,28,28.6,20,9,2,7,8,28,16,0,Matches
559,Raúl de Tomás,es ESP,"DF,FW",Rayo Vallecano,29,1994,0.2,2,2,1,0,1,0,0,,0,0,0,0,0,2,0,0,Matches
560,Pablo Torre,es ESP,"MF,FW",Barcelona,21,2003,3.4,5,4,1,3,1,2,4,50,2,0,0,0,3,8,5,1,Matches
561,David Torres,es ESP,DF,Valladolid,21,2003,15.4,13,8,12,1,0,7,11,63.6,4,19,17,2,10,23,74,0,Matches
562,Ferrán Torres,es ESP,"FW,MF",Barcelona,24,2000,12.3,8,4,2,3,3,3,8,37.5,5,7,1,6,4,12,5,0,Matches
563,Lucas Torró,es ESP,MF,Osasuna,30,1994,32.9,74,41,34,35,5,36,64,56.3,28,36,9,27,45,119,70,3,Matches
564,Hamari Traoré,ml MLI,DF,Real Sociedad,32,1992,7.8,19,12,10,7,2,15,22,68.2,7,6,2,4,9,28,21,0,Matches
565,Óscar Trejo,ar ARG,MF,Rayo Vallecano,36,1988,5.5,8,5,1,5,2,3,9,33.3,6,9,0,9,4,12,5,0,Matches
566,Viktor Tsyhankov,ua UKR,"FW,MF",Girona,26,1997,21.3,19,12,4,7,8,9,19,47.4,10,7,1,6,15,34,16,1,Matches
567,Beñat Turrientes,es ESP,MF,Real Sociedad,22,2002,10.5,15,6,4,10,1,4,15,26.7,11,15,3,12,5,20,14,1,Matches
568,Christantus Uche,ng NGA,"FW,MF",Getafe,21,2003,27.6,35,21,8,19,8,9,20,45,11,20,2,18,10,45,19,0,Matches
569,Naci Ünüvar,nl NED,"MF,DF",Espanyol,21,2003,0.3,2,2,1,1,0,1,2,50,1,0,0,0,0,2,0,0,Matches
570,Óscar Valentín,es ESP,MF,Rayo Vallecano,29,1994,20.4,55,41,21,20,14,33,76,43.4,43,36,8,28,21,76,51,2,Matches
571,Germán Valera,es ESP,MF,Valencia,22,2002,1.6,1,1,1,0,0,0,1,0,1,2,0,2,4,5,2,1,Matches
572,Martin Valjent,sk SVK,DF,Mallorca,28,1995,30.7,30,21,22,7,1,15,25,60,10,32,21,11,18,48,195,1,Matches
573,Jesús Vallejo,es ESP,DF,Real Madrid,27,1997,1.5,0,0,0,0,0,0,0,,0,0,0,0,2,2,8,0,Matches
574,Federico Valverde,uy URU,"MF,DF",Real Madrid,26,1998,33.7,50,30,22,23,5,29,43,67.4,14,38,8,30,55,105,52,1,Matches
575,Siebe Van Der Heyden,be BEL,"DF,MF",Mallorca,26,1998,1.1,1,1,0,1,0,0,0,,0,1,0,1,2,3,3,0,Matches
576,Ruben Vargas,ch SUI,"FW,MF",Sevilla,25,1998,7.5,7,4,1,5,1,3,8,37.5,5,9,0,9,3,10,10,0,Matches
577,José Luis García Vayá,es ESP,MF,Valencia,25,1998,19.4,43,25,24,13,6,19,33,57.6,14,23,6,17,19,62,42,0,Matches
578,Jesus Vazquez,es ESP,DF,Valencia,21,2003,10.2,23,18,12,9,2,10,19,52.6,9,16,5,11,10,33,30,0,Matches
579,Lucas Vázquez,es ESP,DF,Real Madrid,33,1991,24.3,58,34,33,17,8,27,48,56.3,21,24,6,18,17,75,35,1,Matches
580,Alejo Véliz,ar ARG,FW,Espanyol,20,2003,12.5,1,1,0,1,0,1,7,14.3,6,12,2,10,4,5,23,1,Matches
581,Mikel Vesga,es ESP,MF,Athletic Club,31,1993,11,22,15,7,13,2,12,28,42.9,16,10,1,9,15,37,26,0,Matches
582,Carlos Vicente,es ESP,"FW,MF",Alavés,25,1999,34.4,47,31,26,11,10,25,64,39.1,39,34,2,32,14,61,40,0,Matches
583,Pau Victor,es ESP,FW,Barcelona,22,2001,3.5,3,1,0,2,1,0,3,0,3,6,1,5,2,5,5,0,Matches
584,Nacho Vidal,es ESP,DF,Osasuna,29,1995,1.4,2,0,0,1,1,1,4,25,3,1,0,1,0,2,6,0,Matches
585,Fran Vieites,es ESP,GK,Betis,25,1999,4,0,0,0,0,0,0,0,,0,0,0,0,0,0,1,0,Matches
586,Sergio Viera,es ESP,MF,Las Palmas,19,2005,1.1,1,1,0,1,0,0,1,0,1,1,0,1,1,2,1,0,Matches
587,Asier Villalibre,es ESP,FW,Alavés,26,1997,3.7,2,2,0,1,1,1,2,50,1,1,0,1,1,3,7,0,Matches
588,Iván Villar,es ESP,GK,Celta Vigo,27,1997,4,0,0,0,0,0,0,0,,0,0,0,0,0,0,3,0,Matches
589,Viti,es ESP,DF,Las Palmas,26,1997,22,71,46,43,21,7,31,45,68.9,14,28,7,21,27,98,61,0,Matches
590,Daniel Vivian,es ESP,DF,Athletic Club,25,1999,29,40,26,23,14,3,21,32,65.6,11,26,10,16,47,87,152,2,Matches
591,Krapyvtsov Vladyslav,ua UKR,GK,Girona,19,2005,2,0,0,0,0,0,0,0,,0,0,0,0,0,0,1,1,Matches
592,Iñaki Williams,gh GHA,FW,Athletic Club,30,1994,29.5,17,10,4,8,5,12,23,52.2,11,34,5,29,12,29,32,0,Matches
593,Nico Williams,es ESP,FW,Athletic Club,22,2002,22.2,28,18,10,11,7,11,32,34.4,21,20,1,19,7,35,9,0,Matches
594,Axel Witsel,be BEL,DF,Atlético Madrid,35,1989,9.5,16,12,4,10,2,12,14,85.7,2,15,8,7,11,27,34,1,Matches
595,Lamine Yamal,es ESP,FW,Barcelona,17,2007,31.7,42,28,8,17,17,16,38,42.1,22,12,0,12,16,58,3,0,Matches
596,Daniel Yáñez,es ESP,FW,Real Madrid,17,2007,0,0,0,0,0,0,0,0,,0,0,0,0,0,0,0,0,Matches
597,Bertuğ Yıldırım,tr TUR,FW,Getafe,22,2002,12,10,5,0,7,3,2,7,28.6,5,13,2,11,1,11,16,0,Matches
598,Arsen Zakharyan,ru RUS,"MF,FW",Real Sociedad,21,2003,0.8,1,1,1,0,0,1,1,100,0,1,1,0,1,2,0,0,Matches
599,Bryan Zaragoza,es ESP,"FW,MF",Osasuna,23,2001,20.4,13,9,8,4,1,6,21,28.6,15,10,0,10,4,17,8,0,Matches
600,Igor Zubeldia,es ESP,DF,Real Sociedad,27,1997,25.2,34,22,21,10,3,14,26,53.8,12,32,18,14,31,65,100,2,Matches
601,Martín Zubimendi,es ESP,MF,Real Sociedad,25,1999,32.9,73,37,31,29,13,28,44,63.6,16,42,16,26,44,117,79,3,Matches